Date,Description,Category,Amount,Balance,Type
2025-01-30,Zomato Order,Food,-4669,45331,Debit
2024-08-29,Cash Deposit,Cash,-4764,40567,Debit
2024-01-30,Refund,Income,14052,54619,Credit
2025-02-13,UPI to Friend,Transfer,-2483,52136,Debit
2025-03-20,Flipkart Order,Shopping,-839,51297,Debit
2024-07-19,Bank Transfer,Transfer,-3853,47444,Debit
2025-02-06,Cafe Coffee Day,Food,-1573,45871,Debit
2025-02-16,Spotify,Entertainment,-9694,36177,Debit
2024-11-23,Refund,Income,22432,58609,Credit
2024-02-28,Movie Tickets,Entertainment,-4408,54201,Debit
2024-09-15,Doctor Visit,Health,-6443,47758,Debit
2024-04-11,Doctor Visit,Health,-9956,37802,Debit
2025-03-15,Electronics,Shopping,-1379,36423,Debit
2024-12-29,Uber Ride,Transport,-9503,26920,Debit
2024-12-17,Restaurant Bill,Food,-9204,17716,Debit
2024-01-01,Freelance Payment,Income,24633,42349,Credit
2024-07-10,Interest Credit,Savings Interest,6336,48685,Credit
2024-01-17,YouTube Premium,Entertainment,-8701,39984,Debit
2024-07-29,Amazon Purchase,Shopping,-1573,38411,Debit
2024-08-15,Electricity Bill,Utilities,-8133,30278,Debit
2025-01-09,Medical Store,Health,-8229,22049,Debit
2024-04-03,Myntra Shopping,Shopping,-8149,13900,Debit
2024-07-13,Interest Credit,Savings Interest,11801,25701,Credit
2025-03-15,Interest Credit,Savings Interest,25498,51199,Credit
2025-03-14,Internet Recharge,Utilities,-5417,45782,Debit
2024-10-01,Restaurant Bill,Food,-1590,44192,Debit
2024-08-03,Electricity Bill,Utilities,-5391,38801,Debit
2024-11-12,Restaurant Bill,Food,-1536,37265,Debit
2024-12-06,Medical Store,Health,-5403,31862,Debit
2025-04-30,Water Bill,Utilities,-2133,29729,Debit
2024-07-07,FD Interest,Savings Interest,15741,45470,Credit
2024-04-22,Spotify,Entertainment,-9460,36010,Debit
2024-10-22,Bonus,Income,14217,50227,Credit
2024-10-22,Zomato Order,Food,-8051,42176,Debit
2024-03-07,Doctor Visit,Health,-3697,38479,Debit
2024-03-03,Zomato Order,Food,-1173,37306,Debit
2024-05-11,Water Bill,Utilities,-3929,33377,Debit
2024-10-19,Petrol,Transport,-3720,29657,Debit
2024-06-05,Internet Recharge,Utilities,-6709,22948,Debit
2024-11-02,Spotify,Entertainment,-3675,19273,Debit
2024-12-29,Interest Credit,Savings Interest,2183,21456,Credit
2025-01-04,Restaurant Bill,Food,-4061,17395,Debit
2024-02-25,Restaurant Bill,Food,-9035,8360,Debit
2025-02-23,Doctor Visit,Health,-3807,4553,Debit
2024-12-31,Refund,Income,24332,28885,Credit
2025-04-09,Bank Transfer,Transfer,-6567,22318,Debit
2024-03-25,Interest Credit,Savings Interest,13409,35727,Credit
2024-04-09,Interest Credit,Savings Interest,29830,65557,Credit
2024-12-16,Restaurant Bill,Food,-4723,60834,Debit
2024-01-11,Electricity Bill,Utilities,-4994,55840,Debit
2025-02-17,Uber Ride,Transport,-4280,51560,Debit
2024-08-02,ATM Withdrawal,Cash,-5241,46319,Debit
2025-05-13,Electronics,Shopping,-8944,37375,Debit
2024-02-12,Water Bill,Utilities,-3810,33565,Debit
2024-02-24,Petrol,Transport,-7261,26304,Debit
2024-04-14,Doctor Visit,Health,-271,26033,Debit
2024-12-06,Refund,Income,3754,29787,Credit
2025-02-09,UPI to Friend,Transfer,-2598,27189,Debit
2024-04-03,Cash Deposit,Cash,-5620,21569,Debit
2024-12-05,YouTube Premium,Entertainment,-1591,19978,Debit
2025-01-18,Petrol,Transport,-4077,15901,Debit
2024-06-07,Spotify,Entertainment,-111,15790,Debit
2024-01-29,Medical Store,Health,-9880,5910,Debit
2025-05-04,Cafe Coffee Day,Food,-701,5209,Debit
2024-10-27,Electronics,Shopping,-2909,2300,Debit
2024-11-03,Interest Credit,Savings Interest,4607,6907,Credit
2024-01-17,Cash Deposit,Cash,-2519,4388,Debit
2024-10-10,Flipkart Order,Shopping,-3782,606,Debit
2024-08-10,Flipkart Order,Shopping,-9955,-9349,Debit
2024-09-04,Train Ticket,Transport,-7034,-16383,Debit
2025-04-18,Train Ticket,Transport,-5406,-21789,Debit
2024-07-16,ATM Withdrawal,Cash,-4965,-26754,Debit
2024-12-17,Cafe Coffee Day,Food,-2124,-28878,Debit
2024-01-11,Spotify,Entertainment,-8836,-37714,Debit
2025-03-27,Water Bill,Utilities,-9452,-47166,Debit
2024-02-27,Medical Store,Health,-7930,-55096,Debit
2025-03-06,Flipkart Order,Shopping,-885,-55981,Debit
2024-07-30,Flipkart Order,Shopping,-9955,-65936,Debit
2025-02-28,Water Bill,Utilities,-4881,-70817,Debit
2024-01-18,Bonus,Income,18181,-52636,Credit
2024-11-01,ATM Withdrawal,Cash,-8838,-61474,Debit
2024-11-14,FD Interest,Savings Interest,11040,-50434,Credit
2024-11-30,Cafe Coffee Day,Food,-2356,-52790,Debit
2024-10-22,Spotify,Entertainment,-6532,-59322,Debit
2024-05-10,Received from Rahul,Transfer,-291,-59613,Debit
2024-09-13,Medical Store,Health,-1445,-61058,Debit
2024-09-29,YouTube Premium,Entertainment,-7070,-68128,Debit
2024-12-08,Flipkart Order,Shopping,-2196,-70324,Debit
2024-06-20,Movie Tickets,Entertainment,-482,-70806,Debit
2024-08-09,Restaurant Bill,Food,-557,-71363,Debit
2024-07-20,Spotify,Entertainment,-9061,-80424,Debit
2024-06-16,Swiggy,Food,-8194,-88618,Debit
2024-12-25,Received from Rahul,Transfer,-2092,-90710,Debit
2024-12-03,UPI to Friend,Transfer,-7928,-98638,Debit
2024-08-20,Movie Tickets,Entertainment,-8826,-107464,Debit
2024-02-15,Train Ticket,Transport,-9482,-116946,Debit
2024-04-10,Bonus,Income,4526,-112420,Credit
2025-03-23,Water Bill,Utilities,-2889,-115309,Debit
2024-04-22,Internet Recharge,Utilities,-8224,-123533,Debit
2024-08-20,Uber Ride,Transport,-3764,-127297,Debit
2024-03-30,Petrol,Transport,-8123,-135420,Debit
2024-09-29,Doctor Visit,Health,-883,-136303,Debit
2024-12-11,Freelance Payment,Income,6530,-129773,Credit
2024-08-03,Cafe Coffee Day,Food,-9398,-139171,Debit
2024-10-13,Refund,Income,3709,-135462,Credit
2025-01-27,Interest Credit,Savings Interest,22078,-113384,Credit
2024-01-25,ATM Withdrawal,Cash,-8215,-121599,Debit
2024-02-06,Doctor Visit,Health,-5866,-127465,Debit
2024-09-04,Myntra Shopping,Shopping,-2311,-129776,Debit
2025-04-08,Uber Ride,Transport,-5673,-135449,Debit
2024-03-23,Cafe Coffee Day,Food,-5340,-140789,Debit
2024-09-19,Water Bill,Utilities,-6100,-146889,Debit
2024-01-15,Medical Store,Health,-7741,-154630,Debit
2024-10-23,Myntra Shopping,Shopping,-1671,-156301,Debit
2024-04-16,Received from Rahul,Transfer,-8702,-165003,Debit
2024-10-01,Medical Store,Health,-2352,-167355,Debit
2025-02-07,Spotify,Entertainment,-2159,-169514,Debit
2025-03-14,Received from Rahul,Transfer,-1095,-170609,Debit
2025-02-20,Flipkart Order,Shopping,-7707,-178316,Debit
2024-05-21,Medical Store,Health,-4433,-182749,Debit
2024-01-13,Interest Credit,Savings Interest,4154,-178595,Credit
2024-08-28,Interest Credit,Savings Interest,5830,-172765,Credit
2024-09-19,Bonus,Income,8190,-164575,Credit
2024-07-19,FD Interest,Savings Interest,22458,-142117,Credit
2024-06-07,Internet Recharge,Utilities,-1269,-143386,Debit
2024-06-11,ATM Withdrawal,Cash,-5021,-148407,Debit
2025-03-20,Spotify,Entertainment,-9236,-157643,Debit
2025-04-18,Zomato Order,Food,-2537,-160180,Debit
2024-05-06,Spotify,Entertainment,-4185,-164365,Debit
2025-04-28,Movie Tickets,Entertainment,-8940,-173305,Debit
2024-07-13,Restaurant Bill,Food,-8403,-181708,Debit
2025-05-06,Movie Tickets,Entertainment,-1546,-183254,Debit
2024-08-04,YouTube Premium,Entertainment,-2692,-185946,Debit
2024-10-25,ATM Withdrawal,Cash,-659,-186605,Debit
2024-12-16,Movie Tickets,Entertainment,-2622,-189227,Debit
2025-01-22,FD Interest,Savings Interest,10632,-178595,Credit
2024-11-17,Movie Tickets,Entertainment,-9232,-187827,Debit
2024-05-16,Flipkart Order,Shopping,-6810,-194637,Debit
2025-05-04,Bonus,Income,2368,-192269,Credit
2024-01-18,ATM Withdrawal,Cash,-9676,-201945,Debit
2025-03-19,Bank Transfer,Transfer,-2471,-204416,Debit
2024-03-13,Petrol,Transport,-4848,-209264,Debit
2025-05-04,Bonus,Income,27461,-181803,Credit
2024-08-25,Cash Deposit,Cash,-3677,-185480,Debit
2025-04-30,Freelance Payment,Income,25002,-160478,Credit
2024-01-26,Interest Credit,Savings Interest,9790,-150688,Credit
2024-01-28,Received from Rahul,Transfer,-7203,-157891,Debit
2024-02-18,YouTube Premium,Entertainment,-7181,-165072,Debit
2024-08-17,Doctor Visit,Health,-9235,-174307,Debit
2024-12-11,Internet Recharge,Utilities,-5223,-179530,Debit
2025-03-14,Interest Credit,Savings Interest,26449,-153081,Credit
2024-09-05,Swiggy,Food,-2425,-155506,Debit
2024-08-19,YouTube Premium,Entertainment,-3192,-158698,Debit
2025-02-06,Petrol,Transport,-2292,-160990,Debit
2024-08-17,ATM Withdrawal,Cash,-2153,-163143,Debit
2024-04-25,Interest Credit,Savings Interest,5878,-157265,Credit
2024-03-27,Water Bill,Utilities,-7965,-165230,Debit
2025-03-18,Bank Transfer,Transfer,-7893,-173123,Debit
2024-05-29,Bonus,Income,10762,-162361,Credit
2024-11-19,Spotify,Entertainment,-2225,-164586,Debit
2024-07-17,Movie Tickets,Entertainment,-4119,-168705,Debit
2024-09-10,Movie Tickets,Entertainment,-9042,-177747,Debit
2024-09-20,Zomato Order,Food,-2043,-179790,Debit
2024-09-26,Cafe Coffee Day,Food,-3405,-183195,Debit
2024-02-06,Petrol,Transport,-6628,-189823,Debit
2024-08-31,FD Interest,Savings Interest,6921,-182902,Credit
2024-07-14,Swiggy,Food,-7012,-189914,Debit
2024-04-24,Petrol,Transport,-1780,-191694,Debit
2024-05-04,Doctor Visit,Health,-3152,-194846,Debit
2024-08-11,Received from Rahul,Transfer,-9255,-204101,Debit
2024-10-05,ATM Withdrawal,Cash,-6888,-210989,Debit
2025-01-04,Cafe Coffee Day,Food,-2931,-213920,Debit
2025-01-05,Electricity Bill,Utilities,-6146,-220066,Debit
2024-06-17,Petrol,Transport,-2276,-222342,Debit
2025-02-04,ATM Withdrawal,Cash,-5636,-227978,Debit
2025-02-01,Restaurant Bill,Food,-975,-228953,Debit
2024-02-07,Petrol,Transport,-7912,-236865,Debit
2024-04-18,Cafe Coffee Day,Food,-9998,-246863,Debit
2024-05-15,UPI to Friend,Transfer,-8251,-255114,Debit
2024-11-16,Electronics,Shopping,-5466,-260580,Debit
2024-02-08,Electricity Bill,Utilities,-9618,-270198,Debit
2024-08-11,Uber Ride,Transport,-6449,-276647,Debit
2024-11-11,Received from Rahul,Transfer,-2308,-278955,Debit
2024-01-10,Interest Credit,Savings Interest,8315,-270640,Credit
2024-05-18,Electricity Bill,Utilities,-9763,-280403,Debit
2025-04-04,Swiggy,Food,-8177,-288580,Debit
2024-06-07,Doctor Visit,Health,-6098,-294678,Debit
2024-10-27,Bonus,Income,5708,-288970,Credit
2025-04-04,Cafe Coffee Day,Food,-6465,-295435,Debit
2024-12-21,Doctor Visit,Health,-5815,-301250,Debit
2025-02-13,Electricity Bill,Utilities,-2145,-303395,Debit
2024-04-01,Flipkart Order,Shopping,-3311,-306706,Debit
2024-06-14,Uber Ride,Transport,-2263,-308969,Debit
2025-01-05,Uber Ride,Transport,-8182,-317151,Debit
2024-12-19,Received from Rahul,Transfer,-935,-318086,Debit
2024-08-09,Doctor Visit,Health,-2204,-320290,Debit
2024-06-28,ATM Withdrawal,Cash,-380,-320670,Debit
2024-03-28,Refund,Income,19397,-301273,Credit
2024-06-19,Refund,Income,18271,-283002,Credit
2024-02-22,Internet Recharge,Utilities,-1410,-284412,Debit
2024-11-28,Amazon Purchase,Shopping,-265,-284677,Debit
2024-12-19,Cafe Coffee Day,Food,-2842,-287519,Debit
2024-01-20,Restaurant Bill,Food,-5601,-293120,Debit
2024-09-13,Cafe Coffee Day,Food,-4251,-297371,Debit
2024-02-14,Spotify,Entertainment,-9205,-306576,Debit
2024-09-18,Cash Deposit,Cash,-2936,-309512,Debit
2025-05-13,Petrol,Transport,-2802,-312314,Debit
2025-01-31,Doctor Visit,Health,-5178,-317492,Debit
2025-02-20,FD Interest,Savings Interest,20400,-297092,Credit
2024-10-19,Doctor Visit,Health,-4612,-301704,Debit
2024-11-28,Refund,Income,21665,-280039,Credit
2025-03-06,Medical Store,Health,-7045,-287084,Debit
2024-10-03,Interest Credit,Savings Interest,28333,-258751,Credit
2024-03-19,Zomato Order,Food,-1488,-260239,Debit
2024-01-18,Internet Recharge,Utilities,-363,-260602,Debit
2024-04-06,Interest Credit,Savings Interest,26348,-234254,Credit
2024-11-05,Interest Credit,Savings Interest,29219,-205035,Credit
2024-05-05,Doctor Visit,Health,-7059,-212094,Debit
2024-03-28,FD Interest,Savings Interest,21336,-190758,Credit
2024-06-17,Flipkart Order,Shopping,-4752,-195510,Debit
2024-01-27,Cash Deposit,Cash,-4458,-199968,Debit
2025-03-28,Received from Rahul,Transfer,-1305,-201273,Debit
2024-07-10,Myntra Shopping,Shopping,-3356,-204629,Debit
2025-02-16,Movie Tickets,Entertainment,-4463,-209092,Debit
2025-01-09,Internet Recharge,Utilities,-3696,-212788,Debit
2025-01-16,Bank Transfer,Transfer,-7996,-220784,Debit
2025-04-05,Water Bill,Utilities,-6158,-226942,Debit
2024-08-30,Doctor Visit,Health,-6171,-233113,Debit
2024-04-18,Cash Deposit,Cash,-2291,-235404,Debit
2025-04-13,Spotify,Entertainment,-8634,-244038,Debit
2024-03-26,Doctor Visit,Health,-2077,-246115,Debit
2024-05-11,YouTube Premium,Entertainment,-8519,-254634,Debit
2024-04-07,YouTube Premium,Entertainment,-3086,-257720,Debit
2025-05-15,Zomato Order,Food,-810,-258530,Debit
2024-08-12,Refund,Income,15589,-242941,Credit
2024-10-05,Bank Transfer,Transfer,-8025,-250966,Debit
2024-12-28,Petrol,Transport,-7491,-258457,Debit
2024-11-10,Cash Deposit,Cash,-8687,-267144,Debit
2024-12-21,Bonus,Income,22649,-244495,Credit
2024-05-31,Spotify,Entertainment,-4492,-248987,Debit
2024-08-25,Doctor Visit,Health,-7251,-256238,Debit
2024-12-16,Flipkart Order,Shopping,-3882,-260120,Debit
2025-03-14,Electricity Bill,Utilities,-8681,-268801,Debit
2024-02-17,Train Ticket,Transport,-8613,-277414,Debit
2024-08-29,Received from Rahul,Transfer,-5984,-283398,Debit
2024-06-21,Spotify,Entertainment,-9432,-292830,Debit
2024-02-28,Zomato Order,Food,-5061,-297891,Debit
2024-06-25,Uber Ride,Transport,-6575,-304466,Debit
2024-07-11,Swiggy,Food,-6608,-311074,Debit
2024-02-24,Movie Tickets,Entertainment,-9982,-321056,Debit
2025-04-22,Doctor Visit,Health,-8708,-329764,Debit
2024-05-18,UPI to Friend,Transfer,-1800,-331564,Debit
2025-04-30,FD Interest,Savings Interest,23680,-307884,Credit
2024-10-14,Interest Credit,Savings Interest,12284,-295600,Credit
2025-02-15,Cash Deposit,Cash,-6369,-301969,Debit
2024-06-17,Refund,Income,23405,-278564,Credit
2024-10-20,Water Bill,Utilities,-547,-279111,Debit
2024-06-06,ATM Withdrawal,Cash,-2787,-281898,Debit
2024-01-01,Freelance Payment,Income,13802,-268096,Credit
2024-12-19,Interest Credit,Savings Interest,22760,-245336,Credit
2025-02-20,Interest Credit,Savings Interest,16158,-229178,Credit
2024-03-09,Refund,Income,23849,-205329,Credit
2024-08-06,Medical Store,Health,-3675,-209004,Debit
2024-03-20,Electricity Bill,Utilities,-7642,-216646,Debit
2024-05-30,Spotify,Entertainment,-6383,-223029,Debit
2024-08-06,Electronics,Shopping,-2737,-225766,Debit
2025-01-06,Salary Credit,Income,20566,-205200,Credit
2025-02-20,Freelance Payment,Income,10632,-194568,Credit
2024-04-22,FD Interest,Savings Interest,15626,-178942,Credit
2025-05-14,Zomato Order,Food,-4958,-183900,Debit
2024-11-29,Bank Transfer,Transfer,-6123,-190023,Debit
2025-05-01,YouTube Premium,Entertainment,-8332,-198355,Debit
2024-10-20,UPI to Friend,Transfer,-4750,-203105,Debit
2024-03-23,Interest Credit,Savings Interest,26320,-176785,Credit
2025-01-24,Doctor Visit,Health,-3189,-179974,Debit
2024-03-12,FD Interest,Savings Interest,24439,-155535,Credit
2025-05-13,Zomato Order,Food,-2259,-157794,Debit
2024-10-08,Cash Deposit,Cash,-9890,-167684,Debit
2024-04-22,Doctor Visit,Health,-6774,-174458,Debit
2025-04-05,YouTube Premium,Entertainment,-9380,-183838,Debit
2024-04-25,Water Bill,Utilities,-3517,-187355,Debit
2025-02-12,Salary Credit,Income,16168,-171187,Credit
2024-01-18,Refund,Income,5768,-165419,Credit
2024-09-02,Freelance Payment,Income,25014,-140405,Credit
2025-03-07,Zomato Order,Food,-4085,-144490,Debit
2025-02-28,Medical Store,Health,-766,-145256,Debit
2024-09-23,Salary Credit,Income,5636,-139620,Credit
2024-06-08,Myntra Shopping,Shopping,-1534,-141154,Debit
2024-03-11,Uber Ride,Transport,-3457,-144611,Debit
2024-10-23,Freelance Payment,Income,12696,-131915,Credit
2025-04-02,ATM Withdrawal,Cash,-8213,-140128,Debit
2025-01-08,Interest Credit,Savings Interest,21046,-119082,Credit
2024-12-14,Freelance Payment,Income,18455,-100627,Credit
2024-07-31,Spotify,Entertainment,-1477,-102104,Debit
2024-11-25,UPI to Friend,Transfer,-2388,-104492,Debit
2024-04-10,Restaurant Bill,Food,-6963,-111455,Debit
2024-12-26,Refund,Income,26096,-85359,Credit
2024-06-20,FD Interest,Savings Interest,16449,-68910,Credit
2025-02-13,Amazon Purchase,Shopping,-5123,-74033,Debit
2024-09-30,Water Bill,Utilities,-1842,-75875,Debit
2024-10-18,Spotify,Entertainment,-4254,-80129,Debit
2024-03-09,Doctor Visit,Health,-1788,-81917,Debit
2025-04-25,Interest Credit,Savings Interest,19336,-62581,Credit
2024-05-08,Flipkart Order,Shopping,-9783,-72364,Debit
2024-08-31,Freelance Payment,Income,27368,-44996,Credit
2025-01-13,FD Interest,Savings Interest,6335,-38661,Credit
2024-11-11,Movie Tickets,Entertainment,-6964,-45625,Debit
2025-04-24,Movie Tickets,Entertainment,-6265,-51890,Debit
2024-01-24,Swiggy,Food,-3633,-55523,Debit
2025-03-10,Spotify,Entertainment,-6843,-62366,Debit
2024-04-21,Doctor Visit,Health,-2121,-64487,Debit
2025-01-03,Bonus,Income,13697,-50790,Credit
2024-01-27,Salary Credit,Income,11115,-39675,Credit
2024-11-17,Freelance Payment,Income,7990,-31685,Credit
2024-02-14,Received from Rahul,Transfer,-2827,-34512,Debit
2024-09-13,FD Interest,Savings Interest,23943,-10569,Credit
2025-03-15,UPI to Friend,Transfer,-7182,-17751,Debit
2024-09-02,Interest Credit,Savings Interest,14841,-2910,Credit
2024-10-25,Petrol,Transport,-3144,-6054,Debit
2025-04-01,FD Interest,Savings Interest,20821,14767,Credit
2024-06-04,UPI to Friend,Transfer,-562,14205,Debit
2025-03-22,Petrol,Transport,-2869,11336,Debit
2025-02-24,Zomato Order,Food,-563,10773,Debit
2024-03-29,Zomato Order,Food,-7315,3458,Debit
2025-04-10,Petrol,Transport,-4815,-1357,Debit
2025-01-28,Electronics,Shopping,-2155,-3512,Debit
2025-02-19,YouTube Premium,Entertainment,-9066,-12578,Debit
2024-01-22,Myntra Shopping,Shopping,-1758,-14336,Debit
2024-01-03,Flipkart Order,Shopping,-6525,-20861,Debit
2025-03-31,Myntra Shopping,Shopping,-3194,-24055,Debit
2024-06-07,Flipkart Order,Shopping,-255,-24310,Debit
2025-05-08,Electronics,Shopping,-9486,-33796,Debit
2024-06-04,Cash Deposit,Cash,-6558,-40354,Debit
2024-01-04,Water Bill,Utilities,-9605,-49959,Debit
2024-01-08,Myntra Shopping,Shopping,-1992,-51951,Debit
2024-03-24,Water Bill,Utilities,-6945,-58896,Debit
2025-01-24,Amazon Purchase,Shopping,-1600,-60496,Debit
2024-05-19,Cash Deposit,Cash,-604,-61100,Debit
2024-05-04,Movie Tickets,Entertainment,-2088,-63188,Debit
2025-04-22,Doctor Visit,Health,-2145,-65333,Debit
2025-04-11,Cash Deposit,Cash,-2462,-67795,Debit
2025-04-24,Cafe Coffee Day,Food,-9049,-76844,Debit
2024-11-02,Swiggy,Food,-4716,-81560,Debit
2024-12-10,Medical Store,Health,-9567,-91127,Debit
2024-07-16,Flipkart Order,Shopping,-5827,-96954,Debit
2024-12-06,Amazon Purchase,Shopping,-2598,-99552,Debit
2024-10-26,Restaurant Bill,Food,-7349,-106901,Debit
2024-09-22,Swiggy,Food,-2042,-108943,Debit
2024-12-04,Train Ticket,Transport,-4314,-113257,Debit
2024-10-08,ATM Withdrawal,Cash,-7616,-120873,Debit
2024-11-13,Cafe Coffee Day,Food,-8154,-129027,Debit
2024-02-03,ATM Withdrawal,Cash,-8803,-137830,Debit
2025-03-10,Myntra Shopping,Shopping,-7632,-145462,Debit
2024-01-31,Movie Tickets,Entertainment,-3197,-148659,Debit
2025-02-23,Amazon Purchase,Shopping,-1983,-150642,Debit
2024-01-25,Interest Credit,Savings Interest,14733,-135909,Credit
2024-09-02,Cash Deposit,Cash,-7159,-143068,Debit
2024-07-18,Flipkart Order,Shopping,-2416,-145484,Debit
2024-04-21,Electricity Bill,Utilities,-3589,-149073,Debit
2024-02-20,Flipkart Order,Shopping,-3372,-152445,Debit
2024-02-13,Bank Transfer,Transfer,-6014,-158459,Debit
2024-04-05,Train Ticket,Transport,-6180,-164639,Debit
2024-12-09,Salary Credit,Income,5914,-158725,Credit
2025-04-27,Salary Credit,Income,14779,-143946,Credit
2024-05-16,Cafe Coffee Day,Food,-7685,-151631,Debit
2024-07-18,Doctor Visit,Health,-9993,-161624,Debit
2024-07-14,Electronics,Shopping,-6600,-168224,Debit
2025-02-07,Myntra Shopping,Shopping,-8172,-176396,Debit
2024-04-13,Doctor Visit,Health,-7783,-184179,Debit
2025-03-19,YouTube Premium,Entertainment,-3765,-187944,Debit
2024-05-15,Uber Ride,Transport,-1706,-189650,Debit
2025-02-22,Electricity Bill,Utilities,-6214,-195864,Debit
2024-02-20,FD Interest,Savings Interest,19539,-176325,Credit
2024-01-24,FD Interest,Savings Interest,22188,-154137,Credit
2024-12-26,Medical Store,Health,-9873,-164010,Debit
2025-01-26,Water Bill,Utilities,-2589,-166599,Debit
2024-01-21,Cash Deposit,Cash,-805,-167404,Debit
2024-07-08,Electronics,Shopping,-7445,-174849,Debit
2024-07-23,Flipkart Order,Shopping,-7461,-182310,Debit
2024-10-09,Salary Credit,Income,9622,-172688,Credit
2024-07-20,ATM Withdrawal,Cash,-8627,-181315,Debit
2024-10-30,Internet Recharge,Utilities,-3657,-184972,Debit
2024-09-13,ATM Withdrawal,Cash,-5203,-190175,Debit
2024-10-23,Spotify,Entertainment,-9472,-199647,Debit
2025-03-03,Electronics,Shopping,-7999,-207646,Debit
2024-09-03,Bank Transfer,Transfer,-6761,-214407,Debit
2025-01-24,UPI to Friend,Transfer,-9758,-224165,Debit
2024-07-23,FD Interest,Savings Interest,22802,-201363,Credit
2025-03-07,UPI to Friend,Transfer,-5604,-206967,Debit
2024-04-27,Water Bill,Utilities,-9268,-216235,Debit
2024-09-27,Received from Rahul,Transfer,-5219,-221454,Debit
2024-01-27,Medical Store,Health,-9796,-231250,Debit
2024-04-11,Medical Store,Health,-3182,-234432,Debit
2025-01-02,Amazon Purchase,Shopping,-5843,-240275,Debit
2025-04-17,UPI to Friend,Transfer,-9446,-249721,Debit
2024-08-26,Freelance Payment,Income,4071,-245650,Credit
2024-12-22,FD Interest,Savings Interest,22133,-223517,Credit
2024-01-26,UPI to Friend,Transfer,-5365,-228882,Debit
2024-10-08,Freelance Payment,Income,14478,-214404,Credit
2024-09-03,Water Bill,Utilities,-9115,-223519,Debit
2025-02-23,Movie Tickets,Entertainment,-4505,-228024,Debit
2024-08-20,Electricity Bill,Utilities,-4344,-232368,Debit
2024-07-30,Spotify,Entertainment,-1410,-233778,Debit
2025-01-27,Amazon Purchase,Shopping,-4814,-238592,Debit
2024-02-18,Medical Store,Health,-2615,-241207,Debit
2025-04-02,Medical Store,Health,-6680,-247887,Debit
2024-04-22,Freelance Payment,Income,10205,-237682,Credit
2024-09-08,Medical Store,Health,-9745,-247427,Debit
2024-02-17,Spotify,Entertainment,-3972,-251399,Debit
2025-02-26,FD Interest,Savings Interest,10456,-240943,Credit
2024-03-24,Uber Ride,Transport,-9034,-249977,Debit
2025-04-27,Spotify,Entertainment,-6272,-256249,Debit
2024-08-19,Received from Rahul,Transfer,-4744,-260993,Debit
2025-01-25,Freelance Payment,Income,27111,-233882,Credit
2024-11-09,Bank Transfer,Transfer,-8089,-241971,Debit
2024-04-24,Bonus,Income,11618,-230353,Credit
2025-01-23,Restaurant Bill,Food,-7274,-237627,Debit
2025-01-22,Internet Recharge,Utilities,-4674,-242301,Debit
2025-04-09,Salary Credit,Income,3456,-238845,Credit
2024-11-04,FD Interest,Savings Interest,22919,-215926,Credit
2024-02-24,ATM Withdrawal,Cash,-1043,-216969,Debit
2024-03-20,FD Interest,Savings Interest,7077,-209892,Credit
2024-12-03,Received from Rahul,Transfer,-4348,-214240,Debit
2024-09-12,Restaurant Bill,Food,-9893,-224133,Debit
2024-02-15,YouTube Premium,Entertainment,-8908,-233041,Debit
2024-07-02,Freelance Payment,Income,23496,-209545,Credit
2024-02-27,Received from Rahul,Transfer,-3482,-213027,Debit
2024-02-29,Swiggy,Food,-3250,-216277,Debit
2025-04-24,Received from Rahul,Transfer,-9509,-225786,Debit
2024-07-24,Internet Recharge,Utilities,-5147,-230933,Debit
2024-01-16,UPI to Friend,Transfer,-3860,-234793,Debit
2024-01-05,Uber Ride,Transport,-2985,-237778,Debit
2024-02-12,Flipkart Order,Shopping,-7381,-245159,Debit
2024-02-13,Cafe Coffee Day,Food,-5960,-251119,Debit
2024-04-15,UPI to Friend,Transfer,-4339,-255458,Debit
2024-07-28,Petrol,Transport,-5133,-260591,Debit
2024-12-26,Doctor Visit,Health,-2077,-262668,Debit
2025-02-09,Zomato Order,Food,-6909,-269577,Debit
2024-05-11,Cash Deposit,Cash,-8471,-278048,Debit
2024-04-06,Refund,Income,20108,-257940,Credit
2024-09-08,YouTube Premium,Entertainment,-6485,-264425,Debit
2024-12-28,Cash Deposit,Cash,-9668,-274093,Debit
2024-08-06,Myntra Shopping,Shopping,-5734,-279827,Debit
2024-08-04,Cash Deposit,Cash,-8751,-288578,Debit
2024-01-19,Received from Rahul,Transfer,-1299,-289877,Debit
2024-02-14,ATM Withdrawal,Cash,-9829,-299706,Debit
2024-03-24,Received from Rahul,Transfer,-4844,-304550,Debit
2025-02-26,ATM Withdrawal,Cash,-3974,-308524,Debit
2024-05-20,Refund,Income,29982,-278542,Credit
2024-05-13,Uber Ride,Transport,-228,-278770,Debit
2025-01-06,Refund,Income,9521,-269249,Credit
2024-01-09,Swiggy,Food,-3766,-273015,Debit
2024-04-04,Spotify,Entertainment,-3919,-276934,Debit
2025-05-08,Spotify,Entertainment,-6954,-283888,Debit
2024-01-25,Petrol,Transport,-8191,-292079,Debit
2024-08-21,FD Interest,Savings Interest,22766,-269313,Credit
2024-07-04,Doctor Visit,Health,-1582,-270895,Debit
2025-03-13,Doctor Visit,Health,-4626,-275521,Debit
2025-01-02,Doctor Visit,Health,-6440,-281961,Debit
2024-03-20,Internet Recharge,Utilities,-5344,-287305,Debit
2024-07-23,ATM Withdrawal,Cash,-162,-287467,Debit
2024-10-23,YouTube Premium,Entertainment,-6270,-293737,Debit
2024-08-21,Cash Deposit,Cash,-5399,-299136,Debit
2025-04-17,FD Interest,Savings Interest,3813,-295323,Credit
2024-03-05,Doctor Visit,Health,-8337,-303660,Debit
2024-09-25,Received from Rahul,Transfer,-7414,-311074,Debit
2024-04-07,Medical Store,Health,-1825,-312899,Debit
2024-06-10,Flipkart Order,Shopping,-4346,-317245,Debit
2024-03-26,Water Bill,Utilities,-8691,-325936,Debit
2024-12-26,Freelance Payment,Income,6342,-319594,Credit
2025-02-15,Water Bill,Utilities,-8653,-328247,Debit
2024-12-20,YouTube Premium,Entertainment,-937,-329184,Debit
2024-12-24,Electronics,Shopping,-7628,-336812,Debit
2024-04-25,Flipkart Order,Shopping,-3940,-340752,Debit
2024-11-10,Electricity Bill,Utilities,-4450,-345202,Debit
2024-11-22,Cash Deposit,Cash,-5963,-351165,Debit
2024-10-24,Water Bill,Utilities,-241,-351406,Debit
2025-01-11,UPI to Friend,Transfer,-7700,-359106,Debit
2024-03-04,Electronics,Shopping,-1821,-360927,Debit
2024-03-25,Medical Store,Health,-3453,-364380,Debit
2024-02-05,YouTube Premium,Entertainment,-5801,-370181,Debit
2024-05-21,Spotify,Entertainment,-8141,-378322,Debit
2024-10-11,Interest Credit,Savings Interest,9421,-368901,Credit
2024-09-03,Water Bill,Utilities,-6022,-374923,Debit
2024-11-25,Doctor Visit,Health,-7092,-382015,Debit
2024-09-11,ATM Withdrawal,Cash,-5728,-387743,Debit
2025-01-10,Electronics,Shopping,-1374,-389117,Debit
2024-03-20,Refund,Income,6356,-382761,Credit
2024-01-17,Movie Tickets,Entertainment,-8476,-391237,Debit
2024-03-12,Interest Credit,Savings Interest,816,-390421,Credit
2024-03-30,Train Ticket,Transport,-4348,-394769,Debit
2024-03-17,Cash Deposit,Cash,-5446,-400215,Debit
2024-02-27,Petrol,Transport,-9557,-409772,Debit
2024-06-07,Cafe Coffee Day,Food,-8738,-418510,Debit
2025-04-06,FD Interest,Savings Interest,19920,-398590,Credit
2025-02-12,FD Interest,Savings Interest,21675,-376915,Credit
2024-05-23,FD Interest,Savings Interest,24466,-352449,Credit
2024-01-09,FD Interest,Savings Interest,26618,-325831,Credit
2024-12-20,Spotify,Entertainment,-8514,-334345,Debit
2024-07-24,Interest Credit,Savings Interest,16437,-317908,Credit
2025-03-13,Received from Rahul,Transfer,-8978,-326886,Debit
2025-03-22,Medical Store,Health,-1981,-328867,Debit
2024-01-02,Train Ticket,Transport,-8556,-337423,Debit
2024-02-22,ATM Withdrawal,Cash,-6773,-344196,Debit
2024-06-13,Bonus,Income,15910,-328286,Credit
2024-09-07,ATM Withdrawal,Cash,-6476,-334762,Debit
2025-03-19,Movie Tickets,Entertainment,-4827,-339589,Debit
2024-01-11,Internet Recharge,Utilities,-768,-340357,Debit
2025-01-25,Interest Credit,Savings Interest,8712,-331645,Credit
2024-05-02,Doctor Visit,Health,-8619,-340264,Debit
2024-03-11,Internet Recharge,Utilities,-7739,-348003,Debit
2024-07-20,Myntra Shopping,Shopping,-1444,-349447,Debit
2025-04-11,FD Interest,Savings Interest,15863,-333584,Credit
2024-04-29,Refund,Income,19427,-314157,Credit
2024-05-01,Internet Recharge,Utilities,-1794,-315951,Debit
2025-01-17,Freelance Payment,Income,4876,-311075,Credit
2024-02-28,Uber Ride,Transport,-2234,-313309,Debit
2024-11-12,Amazon Purchase,Shopping,-2729,-316038,Debit
2024-07-06,Cash Deposit,Cash,-8896,-324934,Debit
2024-07-01,Electronics,Shopping,-6523,-331457,Debit
2024-09-06,Bonus,Income,6582,-324875,Credit
2024-02-18,Petrol,Transport,-9343,-334218,Debit
2024-07-26,Cafe Coffee Day,Food,-8258,-342476,Debit
2024-09-30,ATM Withdrawal,Cash,-8739,-351215,Debit
2024-04-18,Swiggy,Food,-903,-352118,Debit
2025-05-09,ATM Withdrawal,Cash,-2742,-354860,Debit
2024-11-18,ATM Withdrawal,Cash,-1905,-356765,Debit
2024-10-25,Interest Credit,Savings Interest,12330,-344435,Credit
2025-02-06,Amazon Purchase,Shopping,-7914,-352349,Debit
2025-01-29,Spotify,Entertainment,-9719,-362068,Debit
2024-03-08,Uber Ride,Transport,-1550,-363618,Debit
2024-07-07,FD Interest,Savings Interest,2292,-361326,Credit
2024-10-24,ATM Withdrawal,Cash,-7490,-368816,Debit
2025-02-04,Water Bill,Utilities,-4588,-373404,Debit
2025-02-15,Myntra Shopping,Shopping,-9668,-383072,Debit
2024-11-09,ATM Withdrawal,Cash,-4684,-387756,Debit
2025-01-07,Uber Ride,Transport,-1100,-388856,Debit
2025-04-17,Restaurant Bill,Food,-6193,-395049,Debit
2025-01-26,ATM Withdrawal,Cash,-9156,-404205,Debit
2024-07-23,Electricity Bill,Utilities,-9878,-414083,Debit
2025-04-17,Medical Store,Health,-5083,-419166,Debit
2024-01-02,Electricity Bill,Utilities,-5832,-424998,Debit
2024-02-10,Interest Credit,Savings Interest,13139,-411859,Credit
2024-02-03,Water Bill,Utilities,-3732,-415591,Debit
2024-01-17,Flipkart Order,Shopping,-3981,-419572,Debit
2025-01-18,Movie Tickets,Entertainment,-6862,-426434,Debit
2024-11-22,Flipkart Order,Shopping,-3489,-429923,Debit
2024-10-07,Doctor Visit,Health,-6281,-436204,Debit
2024-08-10,Electricity Bill,Utilities,-6865,-443069,Debit
2024-11-24,Bank Transfer,Transfer,-9968,-453037,Debit
2025-05-15,Movie Tickets,Entertainment,-5021,-458058,Debit
2025-04-10,Bonus,Income,26029,-432029,Credit
2025-04-09,Doctor Visit,Health,-5803,-437832,Debit
2025-04-21,Bank Transfer,Transfer,-7390,-445222,Debit
2025-01-24,Spotify,Entertainment,-4993,-450215,Debit
2024-10-17,Cash Deposit,Cash,-5783,-455998,Debit
2024-12-28,Interest Credit,Savings Interest,22894,-433104,Credit
2024-04-22,UPI to Friend,Transfer,-207,-433311,Debit
2024-06-28,Movie Tickets,Entertainment,-5773,-439084,Debit
2024-06-05,Bank Transfer,Transfer,-3615,-442699,Debit
2025-02-12,Train Ticket,Transport,-856,-443555,Debit
2025-03-31,Internet Recharge,Utilities,-1794,-445349,Debit
2024-03-19,Movie Tickets,Entertainment,-4788,-450137,Debit
2024-10-02,UPI to Friend,Transfer,-7333,-457470,Debit
2024-07-07,ATM Withdrawal,Cash,-9562,-467032,Debit
2024-10-16,Salary Credit,Income,22588,-444444,Credit
2024-11-22,Bank Transfer,Transfer,-9448,-453892,Debit
2024-01-05,Cash Deposit,Cash,-6809,-460701,Debit
2024-07-29,Movie Tickets,Entertainment,-5482,-466183,Debit
2024-02-01,Flipkart Order,Shopping,-8636,-474819,Debit
2024-07-18,Medical Store,Health,-3897,-478716,Debit
2024-10-09,Swiggy,Food,-7548,-486264,Debit
2024-02-19,Swiggy,Food,-9798,-496062,Debit
2024-07-26,Doctor Visit,Health,-9419,-505481,Debit
2024-03-11,Zomato Order,Food,-5282,-510763,Debit
2024-09-25,Doctor Visit,Health,-1394,-512157,Debit
2025-04-25,Uber Ride,Transport,-4105,-516262,Debit
2024-01-07,Uber Ride,Transport,-5343,-521605,Debit
2024-10-30,Myntra Shopping,Shopping,-5511,-527116,Debit
2024-08-22,ATM Withdrawal,Cash,-4429,-531545,Debit
2025-04-29,Freelance Payment,Income,22664,-508881,Credit
2024-04-13,Cash Deposit,Cash,-2641,-511522,Debit
2024-04-06,Received from Rahul,Transfer,-3396,-514918,Debit
2025-02-21,Electricity Bill,Utilities,-2250,-517168,Debit
2025-03-21,Received from Rahul,Transfer,-6203,-523371,Debit
2025-03-15,Medical Store,Health,-3695,-527066,Debit
2024-12-30,Cafe Coffee Day,Food,-6574,-533640,Debit
2024-11-17,Bank Transfer,Transfer,-418,-534058,Debit
2024-02-27,Electricity Bill,Utilities,-9580,-543638,Debit
2025-05-09,Restaurant Bill,Food,-8567,-552205,Debit
2025-02-04,Water Bill,Utilities,-1458,-553663,Debit
2025-02-16,Salary Credit,Income,1145,-552518,Credit
2024-09-07,FD Interest,Savings Interest,20972,-531546,Credit
2024-05-23,Salary Credit,Income,10988,-520558,Credit
2024-09-08,Spotify,Entertainment,-3498,-524056,Debit
2024-12-24,YouTube Premium,Entertainment,-775,-524831,Debit
2024-01-14,Water Bill,Utilities,-592,-525423,Debit
2024-03-24,Bonus,Income,19984,-505439,Credit
2024-02-03,Bonus,Income,27835,-477604,Credit
2024-05-14,Medical Store,Health,-7951,-485555,Debit
2025-03-01,ATM Withdrawal,Cash,-8257,-493812,Debit
2024-12-04,Cash Deposit,Cash,-789,-494601,Debit
2025-03-18,Amazon Purchase,Shopping,-3466,-498067,Debit
2024-10-31,Movie Tickets,Entertainment,-2663,-500730,Debit
2024-10-27,Bank Transfer,Transfer,-4250,-504980,Debit
2025-04-29,Electricity Bill,Utilities,-1718,-506698,Debit
2024-01-11,Spotify,Entertainment,-265,-506963,Debit
2024-08-07,Spotify,Entertainment,-8237,-515200,Debit
2024-11-14,Cafe Coffee Day,Food,-7862,-523062,Debit
2025-05-03,Doctor Visit,Health,-4208,-527270,Debit
2024-12-09,Spotify,Entertainment,-4636,-531906,Debit
2024-02-14,Cash Deposit,Cash,-7625,-539531,Debit
2025-03-11,Medical Store,Health,-1500,-541031,Debit
2024-04-21,Interest Credit,Savings Interest,2721,-538310,Credit
2024-07-24,Movie Tickets,Entertainment,-8530,-546840,Debit
2024-08-14,Restaurant Bill,Food,-3730,-550570,Debit
2024-03-09,Bank Transfer,Transfer,-362,-550932,Debit
2024-08-17,ATM Withdrawal,Cash,-7524,-558456,Debit
2024-04-06,Water Bill,Utilities,-2964,-561420,Debit
2025-01-13,Swiggy,Food,-6489,-567909,Debit
2024-11-14,Cash Deposit,Cash,-1203,-569112,Debit
2025-04-30,Doctor Visit,Health,-479,-569591,Debit
2024-06-11,Internet Recharge,Utilities,-9106,-578697,Debit
2024-10-06,Zomato Order,Food,-7531,-586228,Debit
2024-12-08,FD Interest,Savings Interest,3636,-582592,Credit
2024-02-08,Bonus,Income,10412,-572180,Credit
2024-03-12,ATM Withdrawal,Cash,-6981,-579161,Debit
2024-10-23,Water Bill,Utilities,-4190,-583351,Debit
2025-01-30,Interest Credit,Savings Interest,7132,-576219,Credit
2024-09-17,Internet Recharge,Utilities,-9802,-586021,Debit
2024-06-19,Zomato Order,Food,-4177,-590198,Debit
2025-02-04,Salary Credit,Income,8316,-581882,Credit
2024-08-02,YouTube Premium,Entertainment,-9442,-591324,Debit
2025-04-28,Flipkart Order,Shopping,-3299,-594623,Debit
2024-10-25,Doctor Visit,Health,-8310,-602933,Debit
2024-10-15,Interest Credit,Savings Interest,21416,-581517,Credit
2024-06-30,Myntra Shopping,Shopping,-7084,-588601,Debit
2024-08-12,Movie Tickets,Entertainment,-5840,-594441,Debit
2024-01-21,Bank Transfer,Transfer,-4846,-599287,Debit
2024-11-13,Spotify,Entertainment,-5207,-604494,Debit
2025-01-20,Interest Credit,Savings Interest,20871,-583623,Credit
2024-09-27,Salary Credit,Income,6178,-577445,Credit
2025-02-08,Received from Rahul,Transfer,-5163,-582608,Debit
2024-06-25,Medical Store,Health,-5851,-588459,Debit
2024-04-04,Interest Credit,Savings Interest,10705,-577754,Credit
2025-01-07,Medical Store,Health,-9926,-587680,Debit
2024-05-21,Electronics,Shopping,-1757,-589437,Debit
2024-12-31,Medical Store,Health,-6090,-595527,Debit
2024-07-12,Flipkart Order,Shopping,-1382,-596909,Debit
2024-02-09,Internet Recharge,Utilities,-4995,-601904,Debit
2024-04-24,Movie Tickets,Entertainment,-7576,-609480,Debit
2025-03-16,Freelance Payment,Income,17270,-592210,Credit
2024-12-17,YouTube Premium,Entertainment,-4489,-596699,Debit
2024-02-07,FD Interest,Savings Interest,20295,-576404,Credit
2024-10-14,Medical Store,Health,-7260,-583664,Debit
2025-01-20,Restaurant Bill,Food,-675,-584339,Debit
2024-03-19,Uber Ride,Transport,-9879,-594218,Debit
2024-11-22,Refund,Income,23923,-570295,Credit
2024-05-07,Myntra Shopping,Shopping,-5095,-575390,Debit
2025-03-11,Doctor Visit,Health,-2025,-577415,Debit
2024-02-02,Spotify,Entertainment,-1028,-578443,Debit
2024-08-19,Electronics,Shopping,-8246,-586689,Debit
2024-12-19,Water Bill,Utilities,-2382,-589071,Debit
2024-01-29,Train Ticket,Transport,-579,-589650,Debit
2024-09-08,Myntra Shopping,Shopping,-7577,-597227,Debit
2024-10-17,Petrol,Transport,-3184,-600411,Debit
2024-09-04,Interest Credit,Savings Interest,16960,-583451,Credit
2025-04-25,Uber Ride,Transport,-3639,-587090,Debit
2024-05-03,Freelance Payment,Income,16965,-570125,Credit
2024-12-24,Bank Transfer,Transfer,-8757,-578882,Debit
2024-01-10,FD Interest,Savings Interest,9508,-569374,Credit
2024-11-18,Swiggy,Food,-349,-569723,Debit
2024-04-07,Movie Tickets,Entertainment,-3467,-573190,Debit
2024-12-20,Swiggy,Food,-9209,-582399,Debit
2025-02-03,Train Ticket,Transport,-9496,-591895,Debit
2024-04-23,Freelance Payment,Income,28601,-563294,Credit
2024-07-21,Zomato Order,Food,-2797,-566091,Debit
2024-04-08,Uber Ride,Transport,-5129,-571220,Debit
2024-02-17,ATM Withdrawal,Cash,-1119,-572339,Debit
2024-12-28,Myntra Shopping,Shopping,-9987,-582326,Debit
2024-11-07,Zomato Order,Food,-6160,-588486,Debit
2025-05-11,Movie Tickets,Entertainment,-3921,-592407,Debit
2024-07-14,Spotify,Entertainment,-3634,-596041,Debit
2025-05-06,Electricity Bill,Utilities,-5659,-601700,Debit
2024-07-02,Electricity Bill,Utilities,-8224,-609924,Debit
2025-02-11,FD Interest,Savings Interest,7906,-602018,Credit
2025-04-08,Spotify,Entertainment,-7989,-610007,Debit
2024-07-10,Freelance Payment,Income,8189,-601818,Credit
2025-04-23,Doctor Visit,Health,-2754,-604572,Debit
2024-07-02,Spotify,Entertainment,-8651,-613223,Debit
2024-01-12,Received from Rahul,Transfer,-8251,-621474,Debit
2024-07-12,Amazon Purchase,Shopping,-5718,-627192,Debit
2024-03-02,Electricity Bill,Utilities,-9910,-637102,Debit
2025-01-03,Swiggy,Food,-6954,-644056,Debit
2024-12-09,Restaurant Bill,Food,-8747,-652803,Debit
2024-08-24,Bonus,Income,19148,-633655,Credit
2024-06-01,Bonus,Income,7950,-625705,Credit
2024-05-20,Myntra Shopping,Shopping,-7288,-632993,Debit
2025-02-10,Cash Deposit,Cash,-3047,-636040,Debit
2024-08-06,Internet Recharge,Utilities,-6016,-642056,Debit
2025-04-04,Water Bill,Utilities,-9131,-651187,Debit
2024-10-10,Bonus,Income,4224,-646963,Credit
2024-05-09,Movie Tickets,Entertainment,-1312,-648275,Debit
2025-03-24,Medical Store,Health,-5055,-653330,Debit
2024-04-05,Petrol,Transport,-9896,-663226,Debit
2024-09-16,Restaurant Bill,Food,-9883,-673109,Debit
2025-02-22,ATM Withdrawal,Cash,-5560,-678669,Debit
2024-05-18,Medical Store,Health,-5607,-684276,Debit
2024-09-15,Amazon Purchase,Shopping,-9554,-693830,Debit
2024-10-17,Spotify,Entertainment,-3958,-697788,Debit
2024-07-23,Refund,Income,25260,-672528,Credit
2024-05-31,Swiggy,Food,-8841,-681369,Debit
2024-01-29,Internet Recharge,Utilities,-1936,-683305,Debit
2025-01-01,Spotify,Entertainment,-6821,-690126,Debit
2025-01-28,FD Interest,Savings Interest,8366,-681760,Credit
2025-01-05,Train Ticket,Transport,-1781,-683541,Debit
2024-07-04,Bank Transfer,Transfer,-9858,-693399,Debit
2024-12-15,Train Ticket,Transport,-4233,-697632,Debit
2024-11-27,Internet Recharge,Utilities,-9646,-707278,Debit
2024-09-02,Train Ticket,Transport,-3066,-710344,Debit
2024-08-21,Zomato Order,Food,-2132,-712476,Debit
2024-05-28,UPI to Friend,Transfer,-9777,-722253,Debit
2024-04-22,YouTube Premium,Entertainment,-9182,-731435,Debit
2024-12-25,ATM Withdrawal,Cash,-7427,-738862,Debit
2024-08-25,Movie Tickets,Entertainment,-1978,-740840,Debit
2024-12-17,FD Interest,Savings Interest,9252,-731588,Credit
2024-11-11,Electricity Bill,Utilities,-2509,-734097,Debit
2024-12-22,Water Bill,Utilities,-1106,-735203,Debit
2024-04-13,Zomato Order,Food,-2734,-737937,Debit
2025-03-26,ATM Withdrawal,Cash,-1344,-739281,Debit
2025-05-02,Zomato Order,Food,-3583,-742864,Debit
2024-07-15,Internet Recharge,Utilities,-5428,-748292,Debit
2024-11-01,Cash Deposit,Cash,-2493,-750785,Debit
2024-04-20,Medical Store,Health,-7550,-758335,Debit
2024-06-13,Flipkart Order,Shopping,-3519,-761854,Debit
2024-02-03,YouTube Premium,Entertainment,-5594,-767448,Debit
2024-05-24,Cash Deposit,Cash,-6245,-773693,Debit
2024-12-16,Electricity Bill,Utilities,-9261,-782954,Debit
2024-08-07,Petrol,Transport,-1284,-784238,Debit
2024-05-31,Internet Recharge,Utilities,-4967,-789205,Debit
2024-08-24,Internet Recharge,Utilities,-8054,-797259,Debit
2025-04-07,Electricity Bill,Utilities,-8881,-806140,Debit
2025-01-19,Bank Transfer,Transfer,-7520,-813660,Debit
2024-03-11,Movie Tickets,Entertainment,-1859,-815519,Debit
2024-07-24,Internet Recharge,Utilities,-1941,-817460,Debit
2024-03-29,Cafe Coffee Day,Food,-9355,-826815,Debit
2025-01-14,Interest Credit,Savings Interest,21126,-805689,Credit
2024-10-30,Interest Credit,Savings Interest,20031,-785658,Credit
2025-02-27,Medical Store,Health,-5049,-790707,Debit
2024-12-18,Medical Store,Health,-4819,-795526,Debit
2024-01-21,Uber Ride,Transport,-1692,-797218,Debit
2024-04-23,Train Ticket,Transport,-4224,-801442,Debit
2024-07-13,Water Bill,Utilities,-650,-802092,Debit
2024-03-10,Train Ticket,Transport,-6079,-808171,Debit
2024-04-06,Restaurant Bill,Food,-3051,-811222,Debit
2024-12-16,Doctor Visit,Health,-4275,-815497,Debit
2024-06-19,Electronics,Shopping,-1083,-816580,Debit
2024-04-23,Spotify,Entertainment,-3422,-820002,Debit
2024-01-13,ATM Withdrawal,Cash,-3183,-823185,Debit
2025-04-05,FD Interest,Savings Interest,17660,-805525,Credit
2024-12-17,Uber Ride,Transport,-1383,-806908,Debit
2025-04-13,Movie Tickets,Entertainment,-8310,-815218,Debit
2024-05-20,Swiggy,Food,-5619,-820837,Debit
2025-02-24,Salary Credit,Income,29881,-790956,Credit
2025-02-09,Spotify,Entertainment,-7621,-798577,Debit
2024-02-21,Myntra Shopping,Shopping,-9676,-808253,Debit
2024-01-27,Myntra Shopping,Shopping,-6179,-814432,Debit
2024-03-10,Electricity Bill,Utilities,-3571,-818003,Debit
2024-02-20,Received from Rahul,Transfer,-1744,-819747,Debit
2024-05-15,Spotify,Entertainment,-8979,-828726,Debit
2024-01-30,Train Ticket,Transport,-6665,-835391,Debit
2024-05-05,Interest Credit,Savings Interest,6425,-828966,Credit
2024-05-09,Cash Deposit,Cash,-2178,-831144,Debit
2024-12-29,UPI to Friend,Transfer,-3318,-834462,Debit
2025-02-15,Bank Transfer,Transfer,-4390,-838852,Debit
2024-11-14,Cash Deposit,Cash,-4829,-843681,Debit
2024-11-05,YouTube Premium,Entertainment,-9983,-853664,Debit
2025-02-12,Internet Recharge,Utilities,-2916,-856580,Debit
2024-08-25,Electronics,Shopping,-2566,-859146,Debit
2024-04-09,Restaurant Bill,Food,-1688,-860834,Debit
2025-02-23,Freelance Payment,Income,28242,-832592,Credit
2024-05-21,YouTube Premium,Entertainment,-9274,-841866,Debit
2024-12-22,Spotify,Entertainment,-5433,-847299,Debit
2025-04-30,ATM Withdrawal,Cash,-6729,-854028,Debit
2024-09-15,Electricity Bill,Utilities,-2367,-856395,Debit
2024-06-30,Doctor Visit,Health,-4807,-861202,Debit
2024-05-29,UPI to Friend,Transfer,-8267,-869469,Debit
2024-10-16,Petrol,Transport,-1007,-870476,Debit
2024-07-06,Movie Tickets,Entertainment,-601,-871077,Debit
2024-05-01,Medical Store,Health,-6218,-877295,Debit
2024-02-25,Interest Credit,Savings Interest,17151,-860144,Credit
2024-06-25,Cafe Coffee Day,Food,-3532,-863676,Debit
2025-03-13,Swiggy,Food,-3137,-866813,Debit
2024-11-15,Swiggy,Food,-7196,-874009,Debit
2024-08-02,Freelance Payment,Income,19060,-854949,Credit
2024-05-05,Internet Recharge,Utilities,-165,-855114,Debit
2024-12-13,Myntra Shopping,Shopping,-9532,-864646,Debit
2025-05-11,ATM Withdrawal,Cash,-5032,-869678,Debit
2024-11-13,Interest Credit,Savings Interest,19114,-850564,Credit
2025-04-16,Restaurant Bill,Food,-5137,-855701,Debit
2025-03-17,Electricity Bill,Utilities,-6376,-862077,Debit
2024-06-23,Cash Deposit,Cash,-4487,-866564,Debit
2024-09-21,Cash Deposit,Cash,-4408,-870972,Debit
2024-09-15,Salary Credit,Income,23097,-847875,Credit
2024-08-07,Flipkart Order,Shopping,-5433,-853308,Debit
2024-06-02,Cafe Coffee Day,Food,-131,-853439,Debit
2024-10-26,Interest Credit,Savings Interest,29900,-823539,Credit
2024-04-28,Internet Recharge,Utilities,-2413,-825952,Debit
2024-07-07,Cash Deposit,Cash,-7733,-833685,Debit
2024-05-27,ATM Withdrawal,Cash,-6472,-840157,Debit
2024-05-21,YouTube Premium,Entertainment,-3255,-843412,Debit
2024-12-01,Amazon Purchase,Shopping,-4925,-848337,Debit
2024-04-10,Zomato Order,Food,-7013,-855350,Debit
2024-05-29,ATM Withdrawal,Cash,-1331,-856681,Debit
2025-05-09,Spotify,Entertainment,-2204,-858885,Debit
2024-07-31,Water Bill,Utilities,-331,-859216,Debit
2024-04-28,Swiggy,Food,-1043,-860259,Debit
2024-02-16,Water Bill,Utilities,-1119,-861378,Debit
2025-01-11,Medical Store,Health,-7606,-868984,Debit
2024-08-16,Received from Rahul,Transfer,-9160,-878144,Debit
2025-01-20,YouTube Premium,Entertainment,-5211,-883355,Debit
2024-11-19,Bonus,Income,14289,-869066,Credit
2024-01-06,Bonus,Income,4916,-864150,Credit
2024-12-14,YouTube Premium,Entertainment,-8475,-872625,Debit
2024-06-20,Flipkart Order,Shopping,-7863,-880488,Debit
2024-03-23,Cash Deposit,Cash,-9341,-889829,Debit
2024-08-22,UPI to Friend,Transfer,-5948,-895777,Debit
2024-05-27,Amazon Purchase,Shopping,-4812,-900589,Debit
2024-10-29,Cafe Coffee Day,Food,-6779,-907368,Debit
2024-06-07,Cash Deposit,Cash,-4937,-912305,Debit
2025-03-19,YouTube Premium,Entertainment,-3764,-916069,Debit
2025-02-05,Electricity Bill,Utilities,-3520,-919589,Debit
2025-01-07,Received from Rahul,Transfer,-7149,-926738,Debit
2025-01-23,YouTube Premium,Entertainment,-6572,-933310,Debit
2024-12-12,Medical Store,Health,-1512,-934822,Debit
2024-05-23,Interest Credit,Savings Interest,25484,-909338,Credit
2024-08-26,Medical Store,Health,-3881,-913219,Debit
2024-03-08,Amazon Purchase,Shopping,-6007,-919226,Debit
2024-11-08,Water Bill,Utilities,-2292,-921518,Debit
2024-10-28,Received from Rahul,Transfer,-4659,-926177,Debit
2024-03-22,Medical Store,Health,-4591,-930768,Debit
2024-09-17,Refund,Income,26336,-904432,Credit
2025-01-31,Zomato Order,Food,-7973,-912405,Debit
2025-02-28,ATM Withdrawal,Cash,-6589,-918994,Debit
2024-07-30,Restaurant Bill,Food,-3040,-922034,Debit
2024-05-23,YouTube Premium,Entertainment,-5881,-927915,Debit
2024-07-10,Medical Store,Health,-9180,-937095,Debit
2024-03-16,Myntra Shopping,Shopping,-8157,-945252,Debit
2025-05-10,Salary Credit,Income,28667,-916585,Credit
2025-02-16,Electronics,Shopping,-3629,-920214,Debit
2024-06-18,Zomato Order,Food,-5592,-925806,Debit
2024-09-07,Swiggy,Food,-328,-926134,Debit
2024-02-15,Bonus,Income,5413,-920721,Credit
2024-09-09,Internet Recharge,Utilities,-9457,-930178,Debit
2024-12-17,Salary Credit,Income,28654,-901524,Credit
2025-01-21,Swiggy,Food,-3926,-905450,Debit
2024-05-13,Bonus,Income,17732,-887718,Credit
2024-11-18,Swiggy,Food,-6712,-894430,Debit
2025-03-08,Interest Credit,Savings Interest,9954,-884476,Credit
2024-12-17,Uber Ride,Transport,-4486,-888962,Debit
2024-10-01,Bank Transfer,Transfer,-659,-889621,Debit
2025-04-27,Electronics,Shopping,-1581,-891202,Debit
2024-12-10,YouTube Premium,Entertainment,-2588,-893790,Debit
2024-03-17,Electronics,Shopping,-7728,-901518,Debit
2024-12-18,Uber Ride,Transport,-3778,-905296,Debit
2024-08-08,Interest Credit,Savings Interest,16271,-889025,Credit
2024-01-06,YouTube Premium,Entertainment,-3790,-892815,Debit
2024-10-27,Movie Tickets,Entertainment,-1960,-894775,Debit
2024-09-01,Refund,Income,8013,-886762,Credit
2024-09-23,Medical Store,Health,-4130,-890892,Debit
2024-11-05,Movie Tickets,Entertainment,-4258,-895150,Debit
2025-01-01,Movie Tickets,Entertainment,-9837,-904987,Debit
2025-02-24,Electronics,Shopping,-9340,-914327,Debit
2024-06-15,Electronics,Shopping,-8574,-922901,Debit
2024-03-13,Uber Ride,Transport,-2804,-925705,Debit
2024-07-25,Internet Recharge,Utilities,-9422,-935127,Debit
2024-08-30,Uber Ride,Transport,-9735,-944862,Debit
2024-06-17,Bank Transfer,Transfer,-5198,-950060,Debit
2024-09-17,Doctor Visit,Health,-1543,-951603,Debit
2024-09-30,Flipkart Order,Shopping,-6528,-958131,Debit
2025-05-06,Cash Deposit,Cash,-7526,-965657,Debit
2025-03-08,ATM Withdrawal,Cash,-9823,-975480,Debit
2024-01-16,Medical Store,Health,-2665,-978145,Debit
2025-02-19,Doctor Visit,Health,-7540,-985685,Debit
2024-06-18,Medical Store,Health,-5764,-991449,Debit
2025-02-27,Internet Recharge,Utilities,-2493,-993942,Debit
2024-02-07,Cash Deposit,Cash,-216,-994158,Debit
2024-03-11,Freelance Payment,Income,18794,-975364,Credit
2025-01-26,Medical Store,Health,-7571,-982935,Debit
2024-03-11,Swiggy,Food,-5285,-988220,Debit
2024-09-08,Amazon Purchase,Shopping,-1508,-989728,Debit
2024-02-17,Electronics,Shopping,-7770,-997498,Debit
2025-04-30,Water Bill,Utilities,-4189,-1001687,Debit
2025-03-27,Cafe Coffee Day,Food,-9955,-1011642,Debit
2024-10-19,Freelance Payment,Income,20466,-991176,Credit
2025-04-19,Medical Store,Health,-2787,-993963,Debit
2024-09-20,Zomato Order,Food,-7071,-1001034,Debit
2024-07-25,Salary Credit,Income,28526,-972508,Credit
2025-03-15,Doctor Visit,Health,-8656,-981164,Debit
2025-03-27,Petrol,Transport,-818,-981982,Debit
2024-01-10,FD Interest,Savings Interest,16766,-965216,Credit
2024-06-21,Bonus,Income,14463,-950753,Credit
2024-03-28,Swiggy,Food,-3510,-954263,Debit
2025-01-10,Water Bill,Utilities,-1634,-955897,Debit
2024-05-16,Internet Recharge,Utilities,-5163,-961060,Debit
2025-02-18,Movie Tickets,Entertainment,-5467,-966527,Debit
2024-01-01,Bonus,Income,25718,-940809,Credit
2024-01-18,Myntra Shopping,Shopping,-4224,-945033,Debit
2025-01-15,Internet Recharge,Utilities,-1429,-946462,Debit
2024-12-16,Medical Store,Health,-4396,-950858,Debit
2024-12-19,Spotify,Entertainment,-8779,-959637,Debit
2024-11-27,ATM Withdrawal,Cash,-709,-960346,Debit
2024-11-17,Cash Deposit,Cash,-5389,-965735,Debit
2024-08-17,Cash Deposit,Cash,-5222,-970957,Debit
2024-02-12,Restaurant Bill,Food,-5441,-976398,Debit
2024-09-24,Cash Deposit,Cash,-5525,-981923,Debit
2024-01-20,Petrol,Transport,-5022,-986945,Debit
2024-06-09,UPI to Friend,Transfer,-6763,-993708,Debit
2025-02-19,FD Interest,Savings Interest,8687,-985021,Credit
2024-02-16,Movie Tickets,Entertainment,-2083,-987104,Debit
2024-05-26,Amazon Purchase,Shopping,-6639,-993743,Debit
2024-04-07,Medical Store,Health,-4089,-997832,Debit
2024-12-13,Doctor Visit,Health,-7813,-1005645,Debit
2024-11-30,Uber Ride,Transport,-3363,-1009008,Debit
2024-11-24,Train Ticket,Transport,-2115,-1011123,Debit
2025-02-08,FD Interest,Savings Interest,25877,-985246,Credit
2025-04-09,Spotify,Entertainment,-2989,-988235,Debit
2025-02-13,Spotify,Entertainment,-5652,-993887,Debit
2025-03-11,Petrol,Transport,-9385,-1003272,Debit
2024-02-10,YouTube Premium,Entertainment,-867,-1004139,Debit
2024-01-26,Medical Store,Health,-9128,-1013267,Debit
2024-01-07,YouTube Premium,Entertainment,-1737,-1015004,Debit
2024-11-02,Restaurant Bill,Food,-8009,-1023013,Debit
2024-12-07,Cash Deposit,Cash,-5021,-1028034,Debit
2024-11-15,Bank Transfer,Transfer,-876,-1028910,Debit
2024-05-03,Bank Transfer,Transfer,-1282,-1030192,Debit
2024-03-12,Movie Tickets,Entertainment,-5412,-1035604,Debit
2024-08-31,ATM Withdrawal,Cash,-6998,-1042602,Debit
2024-10-09,Bank Transfer,Transfer,-4738,-1047340,Debit
2024-08-20,Salary Credit,Income,19129,-1028211,Credit
2024-01-03,UPI to Friend,Transfer,-7900,-1036111,Debit
2024-05-11,Bonus,Income,1848,-1034263,Credit
2024-05-01,Received from Rahul,Transfer,-8043,-1042306,Debit
2024-03-22,Electricity Bill,Utilities,-5759,-1048065,Debit
2025-01-01,Cash Deposit,Cash,-2781,-1050846,Debit
2024-03-03,UPI to Friend,Transfer,-9375,-1060221,Debit
2025-04-20,Spotify,Entertainment,-814,-1061035,Debit
2024-06-25,Interest Credit,Savings Interest,21437,-1039598,Credit
2025-03-22,UPI to Friend,Transfer,-4534,-1044132,Debit
2024-06-10,Salary Credit,Income,12598,-1031534,Credit
2024-03-12,Received from Rahul,Transfer,-257,-1031791,Debit
2024-01-04,Interest Credit,Savings Interest,15131,-1016660,Credit
2025-01-15,Petrol,Transport,-6975,-1023635,Debit
2024-09-14,Spotify,Entertainment,-6016,-1029651,Debit
2024-07-23,Internet Recharge,Utilities,-3357,-1033008,Debit
2024-04-07,Movie Tickets,Entertainment,-5275,-1038283,Debit
2024-04-02,Swiggy,Food,-8377,-1046660,Debit
2025-05-11,UPI to Friend,Transfer,-8830,-1055490,Debit
2024-12-02,Electricity Bill,Utilities,-5281,-1060771,Debit
2025-04-12,YouTube Premium,Entertainment,-5971,-1066742,Debit
2025-02-04,Water Bill,Utilities,-3353,-1070095,Debit
2024-01-21,Interest Credit,Savings Interest,22390,-1047705,Credit
2024-08-29,Water Bill,Utilities,-5065,-1052770,Debit
2025-04-20,FD Interest,Savings Interest,6486,-1046284,Credit
2024-07-16,Doctor Visit,Health,-8062,-1054346,Debit
2025-03-08,Bank Transfer,Transfer,-9717,-1064063,Debit
2025-03-19,Freelance Payment,Income,24092,-1039971,Credit
2025-03-13,Internet Recharge,Utilities,-8316,-1048287,Debit
2025-05-10,Amazon Purchase,Shopping,-2416,-1050703,Debit
2024-03-09,Electricity Bill,Utilities,-8934,-1059637,Debit
2024-05-18,FD Interest,Savings Interest,12765,-1046872,Credit
2024-04-19,Cafe Coffee Day,Food,-6859,-1053731,Debit
2024-04-14,Cafe Coffee Day,Food,-3770,-1057501,Debit
2024-01-05,FD Interest,Savings Interest,28582,-1028919,Credit
2025-01-12,Swiggy,Food,-8592,-1037511,Debit
2024-08-20,Train Ticket,Transport,-9397,-1046908,Debit
2024-08-10,Cafe Coffee Day,Food,-4103,-1051011,Debit
2024-07-25,Train Ticket,Transport,-9097,-1060108,Debit
2024-11-30,Movie Tickets,Entertainment,-1587,-1061695,Debit
2024-06-15,Interest Credit,Savings Interest,28712,-1032983,Credit
2025-04-20,Myntra Shopping,Shopping,-9992,-1042975,Debit
2025-03-05,Restaurant Bill,Food,-2030,-1045005,Debit
2025-01-05,Spotify,Entertainment,-6748,-1051753,Debit
2024-12-07,Amazon Purchase,Shopping,-9825,-1061578,Debit
2025-05-06,Movie Tickets,Entertainment,-7356,-1068934,Debit
2024-06-20,Cash Deposit,Cash,-5777,-1074711,Debit
2025-01-24,Cash Deposit,Cash,-4758,-1079469,Debit
2024-10-06,Restaurant Bill,Food,-1375,-1080844,Debit
2024-03-27,Internet Recharge,Utilities,-5398,-1086242,Debit
2024-10-29,FD Interest,Savings Interest,7935,-1078307,Credit
2024-08-28,Doctor Visit,Health,-4262,-1082569,Debit
2024-06-20,Doctor Visit,Health,-4824,-1087393,Debit
2024-10-12,Medical Store,Health,-8643,-1096036,Debit
2025-01-08,Electronics,Shopping,-7300,-1103336,Debit
2025-01-02,UPI to Friend,Transfer,-4255,-1107591,Debit
2025-01-06,Internet Recharge,Utilities,-8967,-1116558,Debit
2024-09-02,YouTube Premium,Entertainment,-1649,-1118207,Debit
2024-10-24,Medical Store,Health,-7647,-1125854,Debit
2025-01-19,Electronics,Shopping,-9232,-1135086,Debit
2024-06-09,Electricity Bill,Utilities,-2173,-1137259,Debit
2024-10-29,YouTube Premium,Entertainment,-1181,-1138440,Debit
2024-08-24,Doctor Visit,Health,-3356,-1141796,Debit
2024-03-24,Received from Rahul,Transfer,-8069,-1149865,Debit
2025-05-13,Spotify,Entertainment,-9604,-1159469,Debit
2025-04-26,Movie Tickets,Entertainment,-9313,-1168782,Debit
2024-07-12,Movie Tickets,Entertainment,-4566,-1173348,Debit
2025-01-05,Salary Credit,Income,24629,-1148719,Credit
2024-02-24,ATM Withdrawal,Cash,-2351,-1151070,Debit
2024-02-08,Bank Transfer,Transfer,-1468,-1152538,Debit
2025-02-25,Flipkart Order,Shopping,-5222,-1157760,Debit
2024-05-05,Refund,Income,19572,-1138188,Credit
2024-03-15,Myntra Shopping,Shopping,-9691,-1147879,Debit
2024-03-04,Amazon Purchase,Shopping,-8116,-1155995,Debit
2024-12-17,Bank Transfer,Transfer,-9534,-1165529,Debit
2025-02-16,FD Interest,Savings Interest,13156,-1152373,Credit
2024-11-27,Electricity Bill,Utilities,-5575,-1157948,Debit
2025-05-06,Salary Credit,Income,13121,-1144827,Credit
2024-04-01,Freelance Payment,Income,25325,-1119502,Credit
2024-09-28,Flipkart Order,Shopping,-2476,-1121978,Debit
2025-01-23,Internet Recharge,Utilities,-466,-1122444,Debit
2024-10-22,Water Bill,Utilities,-602,-1123046,Debit
2024-06-05,Bank Transfer,Transfer,-3093,-1126139,Debit
2024-04-03,Restaurant Bill,Food,-1792,-1127931,Debit
2025-01-31,FD Interest,Savings Interest,27675,-1100256,Credit
2024-10-13,Petrol,Transport,-7780,-1108036,Debit
2024-05-10,Train Ticket,Transport,-9054,-1117090,Debit
2024-11-28,Interest Credit,Savings Interest,17375,-1099715,Credit
2025-01-27,Swiggy,Food,-1717,-1101432,Debit
2025-01-12,Restaurant Bill,Food,-8649,-1110081,Debit
2024-10-07,Train Ticket,Transport,-2845,-1112926,Debit
2024-06-09,Uber Ride,Transport,-1349,-1114275,Debit
2025-02-12,ATM Withdrawal,Cash,-7638,-1121913,Debit
2024-09-28,Electronics,Shopping,-2582,-1124495,Debit
2024-09-16,Freelance Payment,Income,18707,-1105788,Credit
2024-03-01,Movie Tickets,Entertainment,-6834,-1112622,Debit
2025-03-20,Petrol,Transport,-8187,-1120809,Debit
2025-03-07,Restaurant Bill,Food,-2071,-1122880,Debit
2024-04-29,Doctor Visit,Health,-2108,-1124988,Debit
2024-09-10,Received from Rahul,Transfer,-2061,-1127049,Debit
2024-01-05,Restaurant Bill,Food,-2756,-1129805,Debit
2024-06-26,Medical Store,Health,-6453,-1136258,Debit
2024-07-01,Flipkart Order,Shopping,-6495,-1142753,Debit
2024-02-10,Medical Store,Health,-368,-1143121,Debit
2025-03-08,Medical Store,Health,-2720,-1145841,Debit
2024-06-08,Spotify,Entertainment,-831,-1146672,Debit
2025-05-05,Electronics,Shopping,-746,-1147418,Debit
2025-01-17,Internet Recharge,Utilities,-6721,-1154139,Debit
2025-05-02,Flipkart Order,Shopping,-3887,-1158026,Debit
2025-02-06,Cash Deposit,Cash,-5802,-1163828,Debit
2024-12-23,Swiggy,Food,-4763,-1168591,Debit
2025-03-17,Electricity Bill,Utilities,-1457,-1170048,Debit
2024-10-07,Water Bill,Utilities,-4388,-1174436,Debit
2025-04-19,UPI to Friend,Transfer,-7082,-1181518,Debit
2024-12-02,Bank Transfer,Transfer,-8395,-1189913,Debit
2024-07-05,Amazon Purchase,Shopping,-7109,-1197022,Debit
2024-10-21,ATM Withdrawal,Cash,-6165,-1203187,Debit
2025-04-17,Electricity Bill,Utilities,-8653,-1211840,Debit
2024-08-07,Uber Ride,Transport,-6170,-1218010,Debit
2024-09-28,Amazon Purchase,Shopping,-9812,-1227822,Debit
2024-01-22,Swiggy,Food,-4889,-1232711,Debit
2024-01-12,Received from Rahul,Transfer,-8924,-1241635,Debit
2024-10-29,Amazon Purchase,Shopping,-5176,-1246811,Debit
2024-02-02,Cash Deposit,Cash,-7977,-1254788,Debit
2024-06-27,Freelance Payment,Income,25205,-1229583,Credit
2024-01-03,Uber Ride,Transport,-7909,-1237492,Debit
2025-03-26,Medical Store,Health,-120,-1237612,Debit
2024-06-21,Doctor Visit,Health,-8983,-1246595,Debit
2024-07-24,Uber Ride,Transport,-9767,-1256362,Debit
2024-07-10,UPI to Friend,Transfer,-1522,-1257884,Debit
2024-01-01,Water Bill,Utilities,-6290,-1264174,Debit
2025-03-30,Internet Recharge,Utilities,-3814,-1267988,Debit
2025-01-05,Uber Ride,Transport,-3579,-1271567,Debit
2024-06-13,Refund,Income,13673,-1257894,Credit
2025-04-28,Movie Tickets,Entertainment,-1964,-1259858,Debit
2024-09-11,ATM Withdrawal,Cash,-2760,-1262618,Debit
2024-10-19,Water Bill,Utilities,-6108,-1268726,Debit
2024-02-23,UPI to Friend,Transfer,-6945,-1275671,Debit
2024-01-16,Uber Ride,Transport,-744,-1276415,Debit
2024-04-08,UPI to Friend,Transfer,-6518,-1282933,Debit
2024-04-20,Electricity Bill,Utilities,-9153,-1292086,Debit
2024-07-27,Water Bill,Utilities,-149,-1292235,Debit
2024-10-25,Medical Store,Health,-6914,-1299149,Debit
2025-04-04,Salary Credit,Income,8290,-1290859,Credit
2024-04-01,Doctor Visit,Health,-1080,-1291939,Debit
2025-03-23,Electricity Bill,Utilities,-7364,-1299303,Debit
2024-03-02,Myntra Shopping,Shopping,-7760,-1307063,Debit
2025-05-09,Bank Transfer,Transfer,-561,-1307624,Debit
2025-05-01,Received from Rahul,Transfer,-5622,-1313246,Debit
2024-07-25,Restaurant Bill,Food,-1474,-1314720,Debit
2024-10-24,Restaurant Bill,Food,-5518,-1320238,Debit
2024-08-24,Internet Recharge,Utilities,-4878,-1325116,Debit
2024-10-28,Movie Tickets,Entertainment,-4253,-1329369,Debit
2025-03-28,Electricity Bill,Utilities,-6972,-1336341,Debit
2024-10-06,Uber Ride,Transport,-8912,-1345253,Debit
2024-04-20,Flipkart Order,Shopping,-7580,-1352833,Debit
2024-01-14,Doctor Visit,Health,-3611,-1356444,Debit
2024-01-02,Doctor Visit,Health,-2299,-1358743,Debit
2024-04-02,ATM Withdrawal,Cash,-8870,-1367613,Debit
2024-10-26,FD Interest,Savings Interest,8469,-1359144,Credit
2024-08-27,Uber Ride,Transport,-3982,-1363126,Debit
2024-04-07,FD Interest,Savings Interest,18092,-1345034,Credit
2024-07-20,YouTube Premium,Entertainment,-832,-1345866,Debit
2024-04-18,ATM Withdrawal,Cash,-4296,-1350162,Debit
2024-05-21,Medical Store,Health,-9889,-1360051,Debit
2024-07-03,Bank Transfer,Transfer,-8633,-1368684,Debit
2025-04-23,Water Bill,Utilities,-4936,-1373620,Debit
2024-11-14,ATM Withdrawal,Cash,-2003,-1375623,Debit
2025-02-04,UPI to Friend,Transfer,-7105,-1382728,Debit
2025-03-19,UPI to Friend,Transfer,-5568,-1388296,Debit
2024-12-26,Uber Ride,Transport,-1798,-1390094,Debit
2025-04-08,Movie Tickets,Entertainment,-7354,-1397448,Debit
2024-08-22,Refund,Income,2045,-1395403,Credit
2024-12-08,Bonus,Income,19525,-1375878,Credit
2024-06-27,Bank Transfer,Transfer,-7410,-1383288,Debit
2024-12-08,Electricity Bill,Utilities,-7047,-1390335,Debit
2024-05-12,Cash Deposit,Cash,-3048,-1393383,Debit
2024-09-09,Flipkart Order,Shopping,-9563,-1402946,Debit
2024-01-31,Bonus,Income,6779,-1396167,Credit
2024-03-27,Refund,Income,2998,-1393169,Credit
2024-04-13,Received from Rahul,Transfer,-2391,-1395560,Debit
2024-11-12,Restaurant Bill,Food,-8739,-1404299,Debit
2024-05-22,Salary Credit,Income,11738,-1392561,Credit
2024-09-20,Bank Transfer,Transfer,-6472,-1399033,Debit
2024-07-06,Spotify,Entertainment,-7946,-1406979,Debit
2024-07-28,Doctor Visit,Health,-2728,-1409707,Debit
2024-12-05,Doctor Visit,Health,-8639,-1418346,Debit
2025-04-13,Electricity Bill,Utilities,-7006,-1425352,Debit
2024-03-11,Electricity Bill,Utilities,-2604,-1427956,Debit
2024-11-25,Petrol,Transport,-5899,-1433855,Debit
2024-01-27,YouTube Premium,Entertainment,-7253,-1441108,Debit
2025-04-06,Restaurant Bill,Food,-7460,-1448568,Debit
2024-10-17,Cash Deposit,Cash,-857,-1449425,Debit
2024-04-10,Interest Credit,Savings Interest,11267,-1438158,Credit
2024-07-13,Electronics,Shopping,-2116,-1440274,Debit
2024-03-14,Medical Store,Health,-3855,-1444129,Debit
2024-07-06,Train Ticket,Transport,-2667,-1446796,Debit
2024-07-05,Interest Credit,Savings Interest,24751,-1422045,Credit
2024-02-26,Petrol,Transport,-2042,-1424087,Debit
2024-07-29,Train Ticket,Transport,-1711,-1425798,Debit
2025-03-09,Movie Tickets,Entertainment,-9437,-1435235,Debit
2024-06-21,Amazon Purchase,Shopping,-544,-1435779,Debit
2024-06-19,Bonus,Income,18931,-1416848,Credit
2024-11-07,ATM Withdrawal,Cash,-9638,-1426486,Debit
2024-04-11,Internet Recharge,Utilities,-4679,-1431165,Debit
2025-03-12,Water Bill,Utilities,-6747,-1437912,Debit
2024-07-06,Movie Tickets,Entertainment,-4203,-1442115,Debit
2025-01-28,Uber Ride,Transport,-9088,-1451203,Debit
2024-06-17,Cash Deposit,Cash,-5705,-1456908,Debit
2024-08-12,Restaurant Bill,Food,-9362,-1466270,Debit
2024-10-13,Uber Ride,Transport,-2749,-1469019,Debit
2025-05-14,Medical Store,Health,-6316,-1475335,Debit
2025-03-08,Salary Credit,Income,10389,-1464946,Credit
2024-01-29,Received from Rahul,Transfer,-1249,-1466195,Debit
2025-03-08,Movie Tickets,Entertainment,-5037,-1471232,Debit
2024-03-16,Cash Deposit,Cash,-9109,-1480341,Debit
2025-02-01,Spotify,Entertainment,-9577,-1489918,Debit
2024-10-25,Electronics,Shopping,-1802,-1491720,Debit
2024-08-31,Bank Transfer,Transfer,-4449,-1496169,Debit
2024-04-19,Train Ticket,Transport,-2288,-1498457,Debit
2025-03-26,Medical Store,Health,-4170,-1502627,Debit
2025-04-01,Medical Store,Health,-8151,-1510778,Debit
2024-02-27,Medical Store,Health,-4774,-1515552,Debit
2024-04-26,Electronics,Shopping,-1112,-1516664,Debit
2025-02-09,Received from Rahul,Transfer,-456,-1517120,Debit
2025-03-07,Water Bill,Utilities,-8300,-1525420,Debit
2024-03-25,Bonus,Income,23302,-1502118,Credit
2024-09-14,UPI to Friend,Transfer,-9718,-1511836,Debit
2024-11-11,Petrol,Transport,-7622,-1519458,Debit
2024-01-23,Bonus,Income,11247,-1508211,Credit
2024-03-01,Bonus,Income,11496,-1496715,Credit
2024-06-20,Restaurant Bill,Food,-8507,-1505222,Debit
2025-02-01,Zomato Order,Food,-1682,-1506904,Debit
2024-06-24,Salary Credit,Income,7260,-1499644,Credit
2025-02-14,FD Interest,Savings Interest,13575,-1486069,Credit
2024-10-05,Movie Tickets,Entertainment,-1990,-1488059,Debit
2025-04-25,Medical Store,Health,-1803,-1489862,Debit
2025-04-06,Uber Ride,Transport,-6493,-1496355,Debit
2025-04-26,Electronics,Shopping,-2975,-1499330,Debit
2024-10-18,Received from Rahul,Transfer,-1995,-1501325,Debit
2024-12-13,Movie Tickets,Entertainment,-9162,-1510487,Debit
2024-02-05,Interest Credit,Savings Interest,23548,-1486939,Credit
2024-09-13,Restaurant Bill,Food,-3400,-1490339,Debit
2025-04-12,Cafe Coffee Day,Food,-5539,-1495878,Debit
2024-10-31,Internet Recharge,Utilities,-6175,-1502053,Debit
2024-12-05,Electricity Bill,Utilities,-6973,-1509026,Debit
2024-05-21,Spotify,Entertainment,-1951,-1510977,Debit
2024-01-25,Uber Ride,Transport,-3041,-1514018,Debit
2025-03-11,Salary Credit,Income,28264,-1485754,Credit
2024-03-15,Internet Recharge,Utilities,-8622,-1494376,Debit
2024-01-21,Swiggy,Food,-9994,-1504370,Debit
2025-05-09,Doctor Visit,Health,-2007,-1506377,Debit
2024-05-30,Internet Recharge,Utilities,-490,-1506867,Debit
2024-11-10,Train Ticket,Transport,-7825,-1514692,Debit
2024-02-10,Refund,Income,26677,-1488015,Credit
2024-07-08,UPI to Friend,Transfer,-3872,-1491887,Debit
2025-03-06,FD Interest,Savings Interest,7765,-1484122,Credit
2024-05-28,Bank Transfer,Transfer,-4680,-1488802,Debit
2024-10-24,Internet Recharge,Utilities,-1889,-1490691,Debit
2025-02-20,Bonus,Income,25767,-1464924,Credit
2024-09-08,Movie Tickets,Entertainment,-1065,-1465989,Debit
2024-11-26,ATM Withdrawal,Cash,-1330,-1467319,Debit
2024-04-09,Medical Store,Health,-4527,-1471846,Debit
2024-09-09,Cash Deposit,Cash,-7954,-1479800,Debit
2024-03-31,Cafe Coffee Day,Food,-8578,-1488378,Debit
2024-02-28,Received from Rahul,Transfer,-6748,-1495126,Debit
2024-06-16,ATM Withdrawal,Cash,-5100,-1500226,Debit
2025-03-11,Spotify,Entertainment,-5238,-1505464,Debit
2024-01-19,Doctor Visit,Health,-3934,-1509398,Debit
2025-02-07,Cash Deposit,Cash,-4784,-1514182,Debit
2024-11-16,Spotify,Entertainment,-9554,-1523736,Debit
2024-08-03,Cafe Coffee Day,Food,-3103,-1526839,Debit
2024-09-16,Swiggy,Food,-5227,-1532066,Debit
2024-07-17,Train Ticket,Transport,-2139,-1534205,Debit
2025-03-29,Electronics,Shopping,-5851,-1540056,Debit
2024-04-18,Swiggy,Food,-1030,-1541086,Debit
2024-06-01,FD Interest,Savings Interest,28106,-1512980,Credit
2024-02-28,Bonus,Income,28530,-1484450,Credit
2024-03-20,Train Ticket,Transport,-6946,-1491396,Debit
2024-08-09,FD Interest,Savings Interest,5528,-1485868,Credit
2024-08-23,Electricity Bill,Utilities,-8121,-1493989,Debit
2025-04-19,Received from Rahul,Transfer,-9097,-1503086,Debit
2024-12-11,Cafe Coffee Day,Food,-957,-1504043,Debit
2025-03-28,Cash Deposit,Cash,-8465,-1512508,Debit
2024-07-10,Uber Ride,Transport,-5411,-1517919,Debit
2025-03-21,FD Interest,Savings Interest,4362,-1513557,Credit
2025-04-09,Interest Credit,Savings Interest,12547,-1501010,Credit
2025-05-08,Myntra Shopping,Shopping,-6443,-1507453,Debit
2025-05-03,Zomato Order,Food,-8462,-1515915,Debit
2025-04-14,YouTube Premium,Entertainment,-8392,-1524307,Debit
2024-05-11,Spotify,Entertainment,-7034,-1531341,Debit
2024-01-11,Cafe Coffee Day,Food,-2244,-1533585,Debit
2024-07-10,ATM Withdrawal,Cash,-1525,-1535110,Debit
2025-03-28,Electronics,Shopping,-5226,-1540336,Debit
2025-02-16,ATM Withdrawal,Cash,-4100,-1544436,Debit
2024-05-16,Freelance Payment,Income,6501,-1537935,Credit
2025-03-27,Amazon Purchase,Shopping,-7803,-1545738,Debit
2025-04-22,YouTube Premium,Entertainment,-7311,-1553049,Debit
2025-02-17,Bonus,Income,10536,-1542513,Credit
2024-01-01,Water Bill,Utilities,-6394,-1548907,Debit
2024-04-06,Cash Deposit,Cash,-879,-1549786,Debit
2025-05-02,Medical Store,Health,-5115,-1554901,Debit
2024-11-20,Electricity Bill,Utilities,-3521,-1558422,Debit
2025-04-03,ATM Withdrawal,Cash,-7113,-1565535,Debit
2024-03-01,Salary Credit,Income,28837,-1536698,Credit
2024-11-08,Train Ticket,Transport,-5470,-1542168,Debit
2024-01-05,Water Bill,Utilities,-9694,-1551862,Debit
2025-01-23,ATM Withdrawal,Cash,-7573,-1559435,Debit
2024-08-16,Interest Credit,Savings Interest,29591,-1529844,Credit
2025-04-30,Flipkart Order,Shopping,-6578,-1536422,Debit
2024-08-31,FD Interest,Savings Interest,19900,-1516522,Credit
2024-06-09,Amazon Purchase,Shopping,-4896,-1521418,Debit
2024-08-19,Petrol,Transport,-4616,-1526034,Debit
2025-04-20,Spotify,Entertainment,-3977,-1530011,Debit
2024-06-03,Doctor Visit,Health,-2985,-1532996,Debit
2024-03-17,Salary Credit,Income,15594,-1517402,Credit
2025-03-08,Zomato Order,Food,-8000,-1525402,Debit
2024-12-05,Electricity Bill,Utilities,-297,-1525699,Debit
2024-09-27,YouTube Premium,Entertainment,-6747,-1532446,Debit
2025-01-21,Interest Credit,Savings Interest,29216,-1503230,Credit
2025-02-07,Medical Store,Health,-1041,-1504271,Debit
2024-05-14,Cafe Coffee Day,Food,-6083,-1510354,Debit
2025-01-14,Received from Rahul,Transfer,-7076,-1517430,Debit
2024-01-20,Medical Store,Health,-3438,-1520868,Debit
2024-04-22,Medical Store,Health,-5949,-1526817,Debit
2024-03-02,Cash Deposit,Cash,-776,-1527593,Debit
2024-01-27,Petrol,Transport,-7906,-1535499,Debit
2024-09-20,Amazon Purchase,Shopping,-6570,-1542069,Debit
2024-11-21,Train Ticket,Transport,-4126,-1546195,Debit
2024-07-31,Spotify,Entertainment,-9763,-1555958,Debit
2024-03-27,Interest Credit,Savings Interest,29439,-1526519,Credit
2025-02-28,Cafe Coffee Day,Food,-264,-1526783,Debit
2024-01-13,Bank Transfer,Transfer,-3621,-1530404,Debit
2025-01-06,Cash Deposit,Cash,-1369,-1531773,Debit
2024-09-30,Spotify,Entertainment,-6544,-1538317,Debit
2024-07-13,Bonus,Income,28045,-1510272,Credit
2024-02-07,YouTube Premium,Entertainment,-4819,-1515091,Debit
2024-10-22,FD Interest,Savings Interest,2639,-1512452,Credit
2024-10-26,Petrol,Transport,-8335,-1520787,Debit
2024-01-30,Refund,Income,22266,-1498521,Credit
2025-03-21,Water Bill,Utilities,-8393,-1506914,Debit
2024-12-02,Internet Recharge,Utilities,-5719,-1512633,Debit
2024-09-26,Cafe Coffee Day,Food,-268,-1512901,Debit
2024-08-18,Freelance Payment,Income,14736,-1498165,Credit
2024-11-22,Zomato Order,Food,-8376,-1506541,Debit
2024-03-21,Movie Tickets,Entertainment,-571,-1507112,Debit
2025-03-28,Freelance Payment,Income,12781,-1494331,Credit
2024-02-16,Train Ticket,Transport,-6543,-1500874,Debit
2025-03-12,ATM Withdrawal,Cash,-9614,-1510488,Debit
2024-10-28,Bank Transfer,Transfer,-1676,-1512164,Debit
2025-04-25,Medical Store,Health,-7528,-1519692,Debit
2024-07-28,FD Interest,Savings Interest,25380,-1494312,Credit
2024-07-24,Amazon Purchase,Shopping,-1721,-1496033,Debit
2024-10-20,ATM Withdrawal,Cash,-6934,-1502967,Debit
2025-01-04,Restaurant Bill,Food,-3459,-1506426,Debit
2024-08-06,Doctor Visit,Health,-6018,-1512444,Debit
2024-03-11,Refund,Income,13039,-1499405,Credit
2024-11-09,Myntra Shopping,Shopping,-808,-1500213,Debit
2024-04-18,YouTube Premium,Entertainment,-5430,-1505643,Debit
2024-10-21,Freelance Payment,Income,11616,-1494027,Credit
2024-12-19,Medical Store,Health,-7064,-1501091,Debit
2024-05-26,Refund,Income,5590,-1495501,Credit
2024-12-16,YouTube Premium,Entertainment,-1162,-1496663,Debit
2024-01-09,Electricity Bill,Utilities,-9375,-1506038,Debit
2025-04-24,Freelance Payment,Income,9666,-1496372,Credit
2024-08-16,Medical Store,Health,-5005,-1501377,Debit
2024-06-29,Flipkart Order,Shopping,-1133,-1502510,Debit
2024-12-09,Train Ticket,Transport,-7889,-1510399,Debit
2025-03-06,Freelance Payment,Income,19187,-1491212,Credit
2024-06-25,Doctor Visit,Health,-2936,-1494148,Debit
2024-02-19,Freelance Payment,Income,14304,-1479844,Credit
2024-10-24,Internet Recharge,Utilities,-2476,-1482320,Debit
2025-02-23,Medical Store,Health,-8417,-1490737,Debit
2024-11-12,Train Ticket,Transport,-5034,-1495771,Debit
2024-02-26,Received from Rahul,Transfer,-6270,-1502041,Debit
2024-01-21,Doctor Visit,Health,-2374,-1504415,Debit
2024-02-10,Zomato Order,Food,-1608,-1506023,Debit
2025-01-25,Internet Recharge,Utilities,-823,-1506846,Debit
2024-09-14,Medical Store,Health,-3099,-1509945,Debit
2024-10-12,Petrol,Transport,-9377,-1519322,Debit
2025-02-20,Salary Credit,Income,9307,-1510015,Credit
2024-10-20,ATM Withdrawal,Cash,-7128,-1517143,Debit
2024-05-29,UPI to Friend,Transfer,-2200,-1519343,Debit
2024-01-02,Electronics,Shopping,-4224,-1523567,Debit
2024-06-12,Interest Credit,Savings Interest,23666,-1499901,Credit
2024-12-14,Salary Credit,Income,9797,-1490104,Credit
2024-08-23,Spotify,Entertainment,-1880,-1491984,Debit
2024-07-13,Cash Deposit,Cash,-6031,-1498015,Debit
2024-01-14,Freelance Payment,Income,18481,-1479534,Credit
2024-10-17,Water Bill,Utilities,-5431,-1484965,Debit
2024-10-03,Salary Credit,Income,1198,-1483767,Credit
2025-01-31,Restaurant Bill,Food,-7569,-1491336,Debit
2025-05-11,Electricity Bill,Utilities,-8770,-1500106,Debit
2024-02-28,Refund,Income,7415,-1492691,Credit
2024-01-09,FD Interest,Savings Interest,27042,-1465649,Credit
2025-02-25,Doctor Visit,Health,-8367,-1474016,Debit
2024-01-06,Water Bill,Utilities,-5629,-1479645,Debit
2024-01-21,Swiggy,Food,-5103,-1484748,Debit
2024-01-17,Internet Recharge,Utilities,-9930,-1494678,Debit
2024-02-04,Cash Deposit,Cash,-8789,-1503467,Debit
2024-09-14,ATM Withdrawal,Cash,-9644,-1513111,Debit
2024-08-09,Zomato Order,Food,-9683,-1522794,Debit
2024-10-21,Petrol,Transport,-5474,-1528268,Debit
2024-09-21,Train Ticket,Transport,-8541,-1536809,Debit
2024-01-30,Restaurant Bill,Food,-6162,-1542971,Debit
2025-04-15,Amazon Purchase,Shopping,-6681,-1549652,Debit
2024-12-23,FD Interest,Savings Interest,4895,-1544757,Credit
2024-12-02,Cash Deposit,Cash,-3380,-1548137,Debit
2024-08-30,YouTube Premium,Entertainment,-7808,-1555945,Debit
2024-03-13,Zomato Order,Food,-2662,-1558607,Debit
2024-05-08,Bank Transfer,Transfer,-6052,-1564659,Debit
2024-03-20,ATM Withdrawal,Cash,-1324,-1565983,Debit
2024-11-15,Received from Rahul,Transfer,-9212,-1575195,Debit
2024-02-13,Electricity Bill,Utilities,-2363,-1577558,Debit
2024-06-05,Petrol,Transport,-797,-1578355,Debit
2025-03-05,Bank Transfer,Transfer,-1812,-1580167,Debit
2024-10-29,Cash Deposit,Cash,-9221,-1589388,Debit
2024-03-21,Water Bill,Utilities,-7037,-1596425,Debit
2025-05-04,Cash Deposit,Cash,-6257,-1602682,Debit
2024-10-24,Refund,Income,2348,-1600334,Credit
2024-06-17,UPI to Friend,Transfer,-5283,-1605617,Debit
2024-07-16,FD Interest,Savings Interest,8761,-1596856,Credit
2024-01-13,Electricity Bill,Utilities,-6296,-1603152,Debit
2024-04-21,Bank Transfer,Transfer,-6394,-1609546,Debit
2025-01-29,ATM Withdrawal,Cash,-3383,-1612929,Debit
2024-09-30,Swiggy,Food,-3080,-1616009,Debit
2024-07-16,Bank Transfer,Transfer,-488,-1616497,Debit
2025-01-16,Flipkart Order,Shopping,-4560,-1621057,Debit
2024-05-27,ATM Withdrawal,Cash,-205,-1621262,Debit
2024-02-27,Doctor Visit,Health,-9368,-1630630,Debit
2024-10-25,Flipkart Order,Shopping,-8202,-1638832,Debit
2024-03-15,Received from Rahul,Transfer,-8577,-1647409,Debit
2024-08-29,Salary Credit,Income,24183,-1623226,Credit
2025-04-07,Freelance Payment,Income,14291,-1608935,Credit
2024-08-21,YouTube Premium,Entertainment,-6550,-1615485,Debit
2025-02-06,Received from Rahul,Transfer,-6862,-1622347,Debit
2025-01-17,Electronics,Shopping,-6175,-1628522,Debit
2024-04-06,Amazon Purchase,Shopping,-721,-1629243,Debit
2024-02-11,Uber Ride,Transport,-3650,-1632893,Debit
2025-01-26,Movie Tickets,Entertainment,-7589,-1640482,Debit
2024-12-23,Cash Deposit,Cash,-3829,-1644311,Debit
2024-12-11,Swiggy,Food,-4389,-1648700,Debit
2025-01-10,Received from Rahul,Transfer,-605,-1649305,Debit
2024-07-20,Interest Credit,Savings Interest,3097,-1646208,Credit
2024-03-05,Doctor Visit,Health,-5163,-1651371,Debit
2025-01-03,Cafe Coffee Day,Food,-7860,-1659231,Debit
2024-10-15,ATM Withdrawal,Cash,-9759,-1668990,Debit
2024-04-01,Flipkart Order,Shopping,-3151,-1672141,Debit
2025-04-18,UPI to Friend,Transfer,-9746,-1681887,Debit
2024-11-11,Movie Tickets,Entertainment,-3657,-1685544,Debit
2025-04-08,Salary Credit,Income,3254,-1682290,Credit
2024-12-16,YouTube Premium,Entertainment,-4897,-1687187,Debit
2025-03-08,Interest Credit,Savings Interest,29705,-1657482,Credit
2024-10-05,Refund,Income,15887,-1641595,Credit
2025-03-13,Interest Credit,Savings Interest,17273,-1624322,Credit
2024-03-16,Internet Recharge,Utilities,-9893,-1634215,Debit
2025-02-05,Freelance Payment,Income,15710,-1618505,Credit
2025-02-02,UPI to Friend,Transfer,-1575,-1620080,Debit
2024-07-10,Doctor Visit,Health,-6045,-1626125,Debit
2025-02-26,UPI to Friend,Transfer,-4065,-1630190,Debit
2024-02-26,Bonus,Income,25239,-1604951,Credit
2024-02-17,Petrol,Transport,-393,-1605344,Debit
2024-07-27,Uber Ride,Transport,-9631,-1614975,Debit
2024-08-16,Doctor Visit,Health,-1538,-1616513,Debit
2024-12-17,Movie Tickets,Entertainment,-1058,-1617571,Debit
2024-02-12,Movie Tickets,Entertainment,-1641,-1619212,Debit
2024-07-08,Spotify,Entertainment,-8321,-1627533,Debit
2024-05-01,Internet Recharge,Utilities,-7982,-1635515,Debit
2024-04-21,Interest Credit,Savings Interest,27062,-1608453,Credit
2024-12-30,FD Interest,Savings Interest,9790,-1598663,Credit
2024-07-27,Swiggy,Food,-1384,-1600047,Debit
2024-07-20,Petrol,Transport,-5346,-1605393,Debit
2024-08-16,Uber Ride,Transport,-632,-1606025,Debit
2024-10-27,Amazon Purchase,Shopping,-2902,-1608927,Debit
2024-03-12,UPI to Friend,Transfer,-1699,-1610626,Debit
2024-07-28,YouTube Premium,Entertainment,-132,-1610758,Debit
2024-09-13,Bonus,Income,29424,-1581334,Credit
2024-09-16,Cafe Coffee Day,Food,-3067,-1584401,Debit
2025-05-02,Refund,Income,14704,-1569697,Credit
2024-04-20,Salary Credit,Income,26142,-1543555,Credit
2024-11-27,Doctor Visit,Health,-8167,-1551722,Debit
2025-04-12,ATM Withdrawal,Cash,-5652,-1557374,Debit
2024-01-04,ATM Withdrawal,Cash,-3935,-1561309,Debit
2024-02-12,Cafe Coffee Day,Food,-5977,-1567286,Debit
2024-05-25,Electricity Bill,Utilities,-1785,-1569071,Debit
2025-02-02,Swiggy,Food,-5651,-1574722,Debit
2025-04-25,Salary Credit,Income,7209,-1567513,Credit
2024-03-15,Medical Store,Health,-9535,-1577048,Debit
2024-10-12,Movie Tickets,Entertainment,-9428,-1586476,Debit
2024-12-28,Interest Credit,Savings Interest,29671,-1556805,Credit
2024-10-06,Electricity Bill,Utilities,-4377,-1561182,Debit
2024-05-29,Bonus,Income,27459,-1533723,Credit
2024-08-28,Cash Deposit,Cash,-5288,-1539011,Debit
2024-04-01,Internet Recharge,Utilities,-8002,-1547013,Debit
2024-03-29,Flipkart Order,Shopping,-341,-1547354,Debit
2024-09-09,Movie Tickets,Entertainment,-1176,-1548530,Debit
2025-01-07,Electricity Bill,Utilities,-9025,-1557555,Debit
2025-04-04,Electricity Bill,Utilities,-8246,-1565801,Debit
2024-01-19,Doctor Visit,Health,-6890,-1572691,Debit
2024-05-31,Movie Tickets,Entertainment,-6513,-1579204,Debit
2024-09-02,Received from Rahul,Transfer,-6115,-1585319,Debit
2024-05-23,Internet Recharge,Utilities,-3953,-1589272,Debit
2025-03-27,Interest Credit,Savings Interest,13380,-1575892,Credit
2024-10-05,Uber Ride,Transport,-4922,-1580814,Debit
2024-10-29,Myntra Shopping,Shopping,-2840,-1583654,Debit
2024-11-05,Electricity Bill,Utilities,-8750,-1592404,Debit
2024-04-28,Bank Transfer,Transfer,-9058,-1601462,Debit
2024-08-16,Received from Rahul,Transfer,-5596,-1607058,Debit
2024-06-02,Electricity Bill,Utilities,-901,-1607959,Debit
2024-04-28,Cafe Coffee Day,Food,-7665,-1615624,Debit
2024-05-22,Movie Tickets,Entertainment,-279,-1615903,Debit
2025-03-17,Cafe Coffee Day,Food,-6574,-1622477,Debit
2025-03-06,Received from Rahul,Transfer,-2220,-1624697,Debit
2024-01-28,Myntra Shopping,Shopping,-8936,-1633633,Debit
2024-12-23,Freelance Payment,Income,18221,-1615412,Credit
2024-11-13,Spotify,Entertainment,-5114,-1620526,Debit
2024-05-14,Flipkart Order,Shopping,-7429,-1627955,Debit
2025-03-10,Doctor Visit,Health,-8036,-1635991,Debit
2024-10-17,Interest Credit,Savings Interest,29625,-1606366,Credit
2024-04-30,Doctor Visit,Health,-1725,-1608091,Debit
2024-02-23,Zomato Order,Food,-6546,-1614637,Debit
2024-11-21,ATM Withdrawal,Cash,-3619,-1618256,Debit
2024-09-22,Bank Transfer,Transfer,-4099,-1622355,Debit
2024-06-23,Cash Deposit,Cash,-9187,-1631542,Debit
2024-07-10,Refund,Income,3944,-1627598,Credit
2024-07-15,Myntra Shopping,Shopping,-4290,-1631888,Debit
2024-02-12,Water Bill,Utilities,-3124,-1635012,Debit
2024-01-14,Interest Credit,Savings Interest,20408,-1614604,Credit
2024-10-26,Swiggy,Food,-5314,-1619918,Debit
2024-10-07,Train Ticket,Transport,-7445,-1627363,Debit
2025-03-12,Restaurant Bill,Food,-3947,-1631310,Debit
2024-07-20,Swiggy,Food,-9782,-1641092,Debit
2024-04-10,Salary Credit,Income,20686,-1620406,Credit
2024-01-29,Electricity Bill,Utilities,-9147,-1629553,Debit
2024-07-17,Zomato Order,Food,-6738,-1636291,Debit
2024-01-10,Swiggy,Food,-217,-1636508,Debit
2024-03-19,FD Interest,Savings Interest,14498,-1622010,Credit
2024-04-06,Received from Rahul,Transfer,-2071,-1624081,Debit
2025-04-07,Uber Ride,Transport,-690,-1624771,Debit
2025-03-18,Doctor Visit,Health,-7756,-1632527,Debit
2024-01-12,Flipkart Order,Shopping,-322,-1632849,Debit
2024-07-23,Cafe Coffee Day,Food,-186,-1633035,Debit
2024-11-21,ATM Withdrawal,Cash,-1465,-1634500,Debit
2024-09-25,ATM Withdrawal,Cash,-1583,-1636083,Debit
2024-02-01,Electricity Bill,Utilities,-7611,-1643694,Debit
2024-06-17,FD Interest,Savings Interest,627,-1643067,Credit
2024-11-04,Medical Store,Health,-9539,-1652606,Debit
2025-01-29,Uber Ride,Transport,-9862,-1662468,Debit
2024-08-25,Doctor Visit,Health,-9097,-1671565,Debit
2024-10-18,UPI to Friend,Transfer,-8915,-1680480,Debit
2024-02-27,Medical Store,Health,-7837,-1688317,Debit
2025-01-14,Water Bill,Utilities,-164,-1688481,Debit
2024-11-24,Salary Credit,Income,13032,-1675449,Credit
2024-05-21,Train Ticket,Transport,-3512,-1678961,Debit
2024-11-12,Water Bill,Utilities,-5175,-1684136,Debit
2024-01-13,Medical Store,Health,-312,-1684448,Debit
2024-01-05,Electronics,Shopping,-9727,-1694175,Debit
2024-04-07,FD Interest,Savings Interest,24405,-1669770,Credit
2025-04-10,UPI to Friend,Transfer,-5927,-1675697,Debit
2024-12-07,Cash Deposit,Cash,-359,-1676056,Debit
2024-09-12,Medical Store,Health,-7026,-1683082,Debit
2025-01-06,Petrol,Transport,-9708,-1692790,Debit
2024-10-28,Restaurant Bill,Food,-4187,-1696977,Debit
2024-05-30,Doctor Visit,Health,-5145,-1702122,Debit
2025-04-01,Salary Credit,Income,23081,-1679041,Credit
2024-03-20,Doctor Visit,Health,-2561,-1681602,Debit
2025-01-01,Medical Store,Health,-6483,-1688085,Debit
2024-10-09,Doctor Visit,Health,-2832,-1690917,Debit
2024-02-06,Cash Deposit,Cash,-6580,-1697497,Debit
2025-02-06,Cash Deposit,Cash,-8746,-1706243,Debit
2025-03-24,Electronics,Shopping,-2850,-1709093,Debit
2024-03-30,Interest Credit,Savings Interest,20839,-1688254,Credit
2024-10-25,FD Interest,Savings Interest,1581,-1686673,Credit
2025-05-06,Petrol,Transport,-1455,-1688128,Debit
2024-11-26,Internet Recharge,Utilities,-3690,-1691818,Debit
2024-04-27,Uber Ride,Transport,-6602,-1698420,Debit
2024-04-18,Doctor Visit,Health,-9855,-1708275,Debit
2024-02-09,Train Ticket,Transport,-7897,-1716172,Debit
2024-12-15,Bank Transfer,Transfer,-8334,-1724506,Debit
2025-04-13,Electricity Bill,Utilities,-6770,-1731276,Debit
2024-06-21,Refund,Income,10991,-1720285,Credit
2024-05-24,Zomato Order,Food,-5432,-1725717,Debit
2024-02-19,Received from Rahul,Transfer,-5401,-1731118,Debit
2024-03-13,ATM Withdrawal,Cash,-5280,-1736398,Debit
2024-09-10,Amazon Purchase,Shopping,-4499,-1740897,Debit
2024-10-28,Interest Credit,Savings Interest,26824,-1714073,Credit
2024-10-01,Doctor Visit,Health,-5160,-1719233,Debit
2025-03-19,Received from Rahul,Transfer,-6458,-1725691,Debit
2024-03-08,Flipkart Order,Shopping,-6086,-1731777,Debit
2024-03-06,Electricity Bill,Utilities,-6959,-1738736,Debit
2024-01-14,Medical Store,Health,-8359,-1747095,Debit
2024-10-29,Swiggy,Food,-6048,-1753143,Debit
2025-01-25,Restaurant Bill,Food,-2585,-1755728,Debit
2024-09-08,Salary Credit,Income,15603,-1740125,Credit
2024-09-25,Internet Recharge,Utilities,-1973,-1742098,Debit
2025-02-15,Salary Credit,Income,12137,-1729961,Credit
2024-01-03,Salary Credit,Income,25824,-1704137,Credit
2024-01-01,Doctor Visit,Health,-3937,-1708074,Debit
2024-11-10,Doctor Visit,Health,-8543,-1716617,Debit
2024-01-02,Freelance Payment,Income,18244,-1698373,Credit
2025-01-22,Refund,Income,21382,-1676991,Credit
2025-01-24,Movie Tickets,Entertainment,-9310,-1686301,Debit
2025-02-04,ATM Withdrawal,Cash,-9364,-1695665,Debit
2024-06-04,Bank Transfer,Transfer,-1481,-1697146,Debit
2024-09-05,Swiggy,Food,-9132,-1706278,Debit
2024-06-07,Movie Tickets,Entertainment,-7268,-1713546,Debit
2025-03-25,YouTube Premium,Entertainment,-4726,-1718272,Debit
2024-12-05,Movie Tickets,Entertainment,-2245,-1720517,Debit
2024-04-26,Water Bill,Utilities,-8196,-1728713,Debit
2024-01-24,ATM Withdrawal,Cash,-5509,-1734222,Debit
2024-02-15,FD Interest,Savings Interest,15943,-1718279,Credit
2024-08-29,Medical Store,Health,-666,-1718945,Debit
2024-12-23,Water Bill,Utilities,-343,-1719288,Debit
2024-05-22,Myntra Shopping,Shopping,-5839,-1725127,Debit
2024-02-05,Movie Tickets,Entertainment,-4852,-1729979,Debit
2024-11-08,UPI to Friend,Transfer,-8691,-1738670,Debit
2024-11-29,Spotify,Entertainment,-4566,-1743236,Debit
2024-11-25,Bonus,Income,28903,-1714333,Credit
2024-03-02,Petrol,Transport,-6062,-1720395,Debit
2024-11-29,UPI to Friend,Transfer,-4659,-1725054,Debit
2024-11-17,Refund,Income,29991,-1695063,Credit
2024-04-14,ATM Withdrawal,Cash,-4829,-1699892,Debit
2025-04-25,Flipkart Order,Shopping,-6353,-1706245,Debit
2025-03-18,Movie Tickets,Entertainment,-298,-1706543,Debit
2025-02-13,Flipkart Order,Shopping,-6662,-1713205,Debit
2024-02-27,Salary Credit,Income,5872,-1707333,Credit
2024-11-25,Bonus,Income,5567,-1701766,Credit
2025-02-23,Restaurant Bill,Food,-8271,-1710037,Debit
2024-08-18,Restaurant Bill,Food,-1772,-1711809,Debit
2024-06-12,Bonus,Income,8744,-1703065,Credit
2024-01-25,Water Bill,Utilities,-9691,-1712756,Debit
2024-06-01,Received from Rahul,Transfer,-3267,-1716023,Debit
2025-02-01,UPI to Friend,Transfer,-5725,-1721748,Debit
2024-02-17,Flipkart Order,Shopping,-819,-1722567,Debit
2024-05-11,Cash Deposit,Cash,-443,-1723010,Debit
2025-01-28,Swiggy,Food,-6141,-1729151,Debit
2025-02-19,ATM Withdrawal,Cash,-6256,-1735407,Debit
2024-05-27,Restaurant Bill,Food,-5178,-1740585,Debit
2024-09-26,Electronics,Shopping,-1215,-1741800,Debit
2024-09-14,Doctor Visit,Health,-8175,-1749975,Debit
2024-11-16,Received from Rahul,Transfer,-1736,-1751711,Debit
2024-05-31,Bonus,Income,13165,-1738546,Credit
2025-02-15,Internet Recharge,Utilities,-2348,-1740894,Debit
2025-01-27,FD Interest,Savings Interest,23797,-1717097,Credit
2025-02-07,Water Bill,Utilities,-3230,-1720327,Debit
2024-09-23,ATM Withdrawal,Cash,-2364,-1722691,Debit
2025-02-07,Movie Tickets,Entertainment,-8377,-1731068,Debit
2024-01-12,Freelance Payment,Income,30000,-1701068,Credit
2024-11-05,Restaurant Bill,Food,-7414,-1708482,Debit
2025-04-07,Doctor Visit,Health,-6823,-1715305,Debit
2025-02-28,ATM Withdrawal,Cash,-5984,-1721289,Debit
2025-01-29,Bank Transfer,Transfer,-6491,-1727780,Debit
2025-05-04,Electricity Bill,Utilities,-2387,-1730167,Debit
2024-05-03,Electricity Bill,Utilities,-1333,-1731500,Debit
2024-01-29,Water Bill,Utilities,-6614,-1738114,Debit
2025-01-28,Amazon Purchase,Shopping,-6407,-1744521,Debit
2025-01-25,Restaurant Bill,Food,-503,-1745024,Debit
2024-07-30,Train Ticket,Transport,-5476,-1750500,Debit
2025-05-15,Salary Credit,Income,14540,-1735960,Credit
2024-06-17,Spotify,Entertainment,-2674,-1738634,Debit
2025-01-31,Bonus,Income,17845,-1720789,Credit
2024-06-12,Salary Credit,Income,10567,-1710222,Credit
2024-11-12,Medical Store,Health,-8746,-1718968,Debit
2024-12-09,Interest Credit,Savings Interest,16255,-1702713,Credit
2024-03-26,FD Interest,Savings Interest,3819,-1698894,Credit
2024-12-21,Cash Deposit,Cash,-3544,-1702438,Debit
2025-05-01,Water Bill,Utilities,-9897,-1712335,Debit
2025-02-03,Petrol,Transport,-5785,-1718120,Debit
2024-08-27,Water Bill,Utilities,-1524,-1719644,Debit
2025-04-03,Train Ticket,Transport,-7506,-1727150,Debit
2024-08-01,Spotify,Entertainment,-6374,-1733524,Debit
2025-04-15,Electricity Bill,Utilities,-4584,-1738108,Debit
2024-12-15,Swiggy,Food,-7252,-1745360,Debit
2024-12-23,Flipkart Order,Shopping,-6590,-1751950,Debit
2024-10-24,FD Interest,Savings Interest,27196,-1724754,Credit
2024-11-24,Interest Credit,Savings Interest,5976,-1718778,Credit
2024-05-03,Refund,Income,27162,-1691616,Credit
2024-01-01,Refund,Income,6901,-1684715,Credit
2024-06-10,Zomato Order,Food,-151,-1684866,Debit
2024-02-19,Flipkart Order,Shopping,-380,-1685246,Debit
2024-06-12,Medical Store,Health,-4798,-1690044,Debit
2025-03-08,Train Ticket,Transport,-2026,-1692070,Debit
2024-12-24,Bank Transfer,Transfer,-2544,-1694614,Debit
2024-06-05,YouTube Premium,Entertainment,-3515,-1698129,Debit
2024-05-04,Amazon Purchase,Shopping,-8701,-1706830,Debit
2024-01-17,Received from Rahul,Transfer,-8576,-1715406,Debit
2025-01-28,Cash Deposit,Cash,-2519,-1717925,Debit
2024-03-12,Train Ticket,Transport,-7543,-1725468,Debit
2024-06-20,Bank Transfer,Transfer,-6063,-1731531,Debit
2024-06-07,YouTube Premium,Entertainment,-376,-1731907,Debit
2025-03-30,Bonus,Income,3457,-1728450,Credit
2025-04-03,Spotify,Entertainment,-3531,-1731981,Debit
2024-11-21,UPI to Friend,Transfer,-8066,-1740047,Debit
2024-08-28,FD Interest,Savings Interest,953,-1739094,Credit
2025-03-11,Medical Store,Health,-6570,-1745664,Debit
2024-09-01,Bank Transfer,Transfer,-2698,-1748362,Debit
2024-10-26,Interest Credit,Savings Interest,10720,-1737642,Credit
2024-03-19,Cash Deposit,Cash,-563,-1738205,Debit
2024-12-01,UPI to Friend,Transfer,-5794,-1743999,Debit
2024-11-14,Movie Tickets,Entertainment,-6431,-1750430,Debit
2025-01-20,Medical Store,Health,-4802,-1755232,Debit
2024-01-08,YouTube Premium,Entertainment,-7589,-1762821,Debit
2024-11-02,Train Ticket,Transport,-7812,-1770633,Debit
2024-05-26,Received from Rahul,Transfer,-5417,-1776050,Debit
2025-01-06,Petrol,Transport,-8922,-1784972,Debit
2024-12-09,Movie Tickets,Entertainment,-6866,-1791838,Debit
2025-03-02,Movie Tickets,Entertainment,-8105,-1799943,Debit
2024-09-20,UPI to Friend,Transfer,-1285,-1801228,Debit
2024-06-13,Internet Recharge,Utilities,-5722,-1806950,Debit
2024-05-12,Cash Deposit,Cash,-7368,-1814318,Debit
2024-01-24,ATM Withdrawal,Cash,-5400,-1819718,Debit
2024-01-27,Petrol,Transport,-4576,-1824294,Debit
2024-12-18,Bonus,Income,22542,-1801752,Credit
2024-03-30,Cafe Coffee Day,Food,-7031,-1808783,Debit
2024-04-08,Received from Rahul,Transfer,-6224,-1815007,Debit
2024-07-18,Bonus,Income,9112,-1805895,Credit
2024-06-27,Water Bill,Utilities,-8064,-1813959,Debit
2025-01-07,Medical Store,Health,-1900,-1815859,Debit
2024-04-17,Cash Deposit,Cash,-5564,-1821423,Debit
2024-12-05,Petrol,Transport,-2507,-1823930,Debit
2024-05-21,YouTube Premium,Entertainment,-4406,-1828336,Debit
2025-02-20,Uber Ride,Transport,-7340,-1835676,Debit
2025-01-31,Myntra Shopping,Shopping,-2606,-1838282,Debit
2025-04-07,Electricity Bill,Utilities,-6067,-1844349,Debit
2024-01-01,Doctor Visit,Health,-2681,-1847030,Debit
2025-04-05,FD Interest,Savings Interest,3969,-1843061,Credit
2024-02-17,Electronics,Shopping,-8499,-1851560,Debit
2024-09-25,Cafe Coffee Day,Food,-4237,-1855797,Debit
2024-11-07,Electricity Bill,Utilities,-8842,-1864639,Debit
2025-01-20,Cash Deposit,Cash,-4868,-1869507,Debit
2024-08-09,Electronics,Shopping,-1152,-1870659,Debit
2024-07-06,Medical Store,Health,-7403,-1878062,Debit
2024-12-20,Bank Transfer,Transfer,-4057,-1882119,Debit
2024-12-08,Refund,Income,10555,-1871564,Credit
2025-05-14,Uber Ride,Transport,-2118,-1873682,Debit
2024-01-04,Zomato Order,Food,-2546,-1876228,Debit
2024-12-08,Internet Recharge,Utilities,-2849,-1879077,Debit
2024-04-26,Cash Deposit,Cash,-8439,-1887516,Debit
2024-09-28,Refund,Income,12266,-1875250,Credit
2024-09-16,Cash Deposit,Cash,-8081,-1883331,Debit
2024-08-23,Bank Transfer,Transfer,-4987,-1888318,Debit
2024-03-07,Bank Transfer,Transfer,-5141,-1893459,Debit
2024-06-23,Zomato Order,Food,-4575,-1898034,Debit
2024-07-22,Cash Deposit,Cash,-110,-1898144,Debit
2024-11-14,Bank Transfer,Transfer,-2525,-1900669,Debit
2025-03-05,Interest Credit,Savings Interest,18201,-1882468,Credit
2024-02-24,Electronics,Shopping,-7419,-1889887,Debit
2024-07-11,Myntra Shopping,Shopping,-414,-1890301,Debit
2024-05-19,YouTube Premium,Entertainment,-6892,-1897193,Debit
2024-06-19,Freelance Payment,Income,29253,-1867940,Credit
2025-04-21,UPI to Friend,Transfer,-8340,-1876280,Debit
2024-12-11,Zomato Order,Food,-7158,-1883438,Debit
2024-02-09,Water Bill,Utilities,-8904,-1892342,Debit
2024-10-29,Bank Transfer,Transfer,-5953,-1898295,Debit
2024-01-01,Freelance Payment,Income,29821,-1868474,Credit
2024-10-26,Water Bill,Utilities,-1575,-1870049,Debit
2024-05-23,Freelance Payment,Income,9613,-1860436,Credit
2025-02-27,Train Ticket,Transport,-6241,-1866677,Debit
2024-04-24,Doctor Visit,Health,-2018,-1868695,Debit
2024-01-28,Petrol,Transport,-3619,-1872314,Debit
2024-04-16,Internet Recharge,Utilities,-784,-1873098,Debit
2024-12-07,Uber Ride,Transport,-2346,-1875444,Debit
2024-10-28,Medical Store,Health,-1989,-1877433,Debit
2024-08-03,Medical Store,Health,-4929,-1882362,Debit
2024-02-03,Bank Transfer,Transfer,-9178,-1891540,Debit
2024-12-31,Movie Tickets,Entertainment,-8462,-1900002,Debit
2025-04-11,Amazon Purchase,Shopping,-8414,-1908416,Debit
2024-10-02,ATM Withdrawal,Cash,-5010,-1913426,Debit
2025-04-15,Spotify,Entertainment,-7947,-1921373,Debit
2024-04-26,Received from Rahul,Transfer,-6265,-1927638,Debit
2024-02-26,Freelance Payment,Income,20498,-1907140,Credit
2025-01-04,Freelance Payment,Income,11959,-1895181,Credit
2024-05-14,Flipkart Order,Shopping,-7197,-1902378,Debit
2024-06-01,Water Bill,Utilities,-6718,-1909096,Debit
2024-10-23,UPI to Friend,Transfer,-8479,-1917575,Debit
2025-03-15,Received from Rahul,Transfer,-926,-1918501,Debit
2025-04-18,Electronics,Shopping,-4787,-1923288,Debit
2025-03-16,Movie Tickets,Entertainment,-6609,-1929897,Debit
2024-02-19,YouTube Premium,Entertainment,-7834,-1937731,Debit
2024-01-16,Interest Credit,Savings Interest,7433,-1930298,Credit
2024-07-26,Doctor Visit,Health,-5607,-1935905,Debit
2024-01-15,Myntra Shopping,Shopping,-8149,-1944054,Debit
2024-09-15,Water Bill,Utilities,-7235,-1951289,Debit
2024-05-15,ATM Withdrawal,Cash,-827,-1952116,Debit
2024-05-05,Cash Deposit,Cash,-3133,-1955249,Debit
2024-12-09,Medical Store,Health,-4941,-1960190,Debit
2024-12-18,Zomato Order,Food,-2392,-1962582,Debit
2024-08-11,ATM Withdrawal,Cash,-8359,-1970941,Debit
2025-03-30,Received from Rahul,Transfer,-3806,-1974747,Debit
2024-08-09,Refund,Income,12800,-1961947,Credit
2024-06-16,ATM Withdrawal,Cash,-8668,-1970615,Debit
2024-05-03,Salary Credit,Income,6432,-1964183,Credit
2024-07-30,Petrol,Transport,-6946,-1971129,Debit
2024-02-29,Zomato Order,Food,-545,-1971674,Debit
2025-04-08,Uber Ride,Transport,-2685,-1974359,Debit
2024-05-11,Swiggy,Food,-163,-1974522,Debit
2024-08-17,Bank Transfer,Transfer,-207,-1974729,Debit
2025-01-24,FD Interest,Savings Interest,1277,-1973452,Credit
2024-05-28,Medical Store,Health,-2623,-1976075,Debit
2024-06-13,Movie Tickets,Entertainment,-4935,-1981010,Debit
2024-11-13,Restaurant Bill,Food,-6640,-1987650,Debit
2024-11-03,Medical Store,Health,-4481,-1992131,Debit
2024-01-08,Electricity Bill,Utilities,-8142,-2000273,Debit
2024-10-17,Bonus,Income,8725,-1991548,Credit
2025-02-28,Water Bill,Utilities,-4636,-1996184,Debit
2025-02-26,ATM Withdrawal,Cash,-541,-1996725,Debit
2024-08-13,Spotify,Entertainment,-5462,-2002187,Debit
2024-03-24,Cash Deposit,Cash,-8148,-2010335,Debit
2024-02-23,Swiggy,Food,-2155,-2012490,Debit
2024-01-13,Received from Rahul,Transfer,-9891,-2022381,Debit
2024-08-12,Uber Ride,Transport,-3978,-2026359,Debit
2025-02-19,Medical Store,Health,-6186,-2032545,Debit
2024-06-21,Internet Recharge,Utilities,-3007,-2035552,Debit
2024-11-16,Petrol,Transport,-6534,-2042086,Debit
2024-01-20,Doctor Visit,Health,-4718,-2046804,Debit
2024-12-10,Restaurant Bill,Food,-5723,-2052527,Debit
2024-04-19,ATM Withdrawal,Cash,-9128,-2061655,Debit
2025-04-30,Flipkart Order,Shopping,-9550,-2071205,Debit
2024-07-19,Bank Transfer,Transfer,-4541,-2075746,Debit
2025-03-11,ATM Withdrawal,Cash,-6804,-2082550,Debit
2024-03-04,Electricity Bill,Utilities,-8069,-2090619,Debit
2025-04-12,Medical Store,Health,-5881,-2096500,Debit
2024-09-02,Internet Recharge,Utilities,-8905,-2105405,Debit
2024-06-12,Cash Deposit,Cash,-254,-2105659,Debit
2025-02-19,YouTube Premium,Entertainment,-2797,-2108456,Debit
2025-03-26,Myntra Shopping,Shopping,-1527,-2109983,Debit
2024-01-22,Bank Transfer,Transfer,-5272,-2115255,Debit
2024-09-23,Spotify,Entertainment,-2909,-2118164,Debit
2024-10-17,Refund,Income,11894,-2106270,Credit
2024-08-30,Uber Ride,Transport,-9629,-2115899,Debit
2024-05-01,Bank Transfer,Transfer,-1954,-2117853,Debit
2024-05-26,Zomato Order,Food,-6322,-2124175,Debit
2024-11-22,FD Interest,Savings Interest,19748,-2104427,Credit
2024-07-07,Medical Store,Health,-7930,-2112357,Debit
2024-04-08,Refund,Income,10873,-2101484,Credit
2024-02-22,Myntra Shopping,Shopping,-4409,-2105893,Debit
2024-01-11,Freelance Payment,Income,18146,-2087747,Credit
2025-01-20,Uber Ride,Transport,-8716,-2096463,Debit
2024-04-16,Uber Ride,Transport,-5284,-2101747,Debit
2024-08-28,Salary Credit,Income,20627,-2081120,Credit
2024-09-05,Electricity Bill,Utilities,-5938,-2087058,Debit
2024-10-19,YouTube Premium,Entertainment,-698,-2087756,Debit
2024-11-21,Flipkart Order,Shopping,-1083,-2088839,Debit
2024-01-31,Petrol,Transport,-3598,-2092437,Debit
2024-09-10,Spotify,Entertainment,-8371,-2100808,Debit
2025-02-25,Electronics,Shopping,-6946,-2107754,Debit
2024-11-16,Bank Transfer,Transfer,-5118,-2112872,Debit
2024-04-27,Doctor Visit,Health,-9276,-2122148,Debit
2024-02-17,Train Ticket,Transport,-3234,-2125382,Debit
2025-02-14,Zomato Order,Food,-2321,-2127703,Debit
2025-03-10,Medical Store,Health,-367,-2128070,Debit
2024-09-24,YouTube Premium,Entertainment,-6317,-2134387,Debit
2024-02-14,YouTube Premium,Entertainment,-8900,-2143287,Debit
2024-04-28,Spotify,Entertainment,-9413,-2152700,Debit
2024-07-14,ATM Withdrawal,Cash,-5825,-2158525,Debit
2024-03-08,Movie Tickets,Entertainment,-2197,-2160722,Debit
2024-01-16,Interest Credit,Savings Interest,16956,-2143766,Credit
2024-03-19,Refund,Income,5291,-2138475,Credit
2024-06-19,Cafe Coffee Day,Food,-3468,-2141943,Debit
2024-09-01,Medical Store,Health,-1358,-2143301,Debit
2024-02-10,Petrol,Transport,-7604,-2150905,Debit
2025-02-26,Medical Store,Health,-7493,-2158398,Debit
2024-01-17,Refund,Income,25728,-2132670,Credit
2024-07-13,Train Ticket,Transport,-1872,-2134542,Debit
2024-01-29,Amazon Purchase,Shopping,-1790,-2136332,Debit
2025-04-30,Freelance Payment,Income,5342,-2130990,Credit
2024-10-13,Swiggy,Food,-7158,-2138148,Debit
2025-02-22,Myntra Shopping,Shopping,-3660,-2141808,Debit
2024-05-15,Doctor Visit,Health,-6807,-2148615,Debit
2024-12-17,Internet Recharge,Utilities,-4520,-2153135,Debit
2024-07-11,Cash Deposit,Cash,-4399,-2157534,Debit
2024-06-12,Internet Recharge,Utilities,-3935,-2161469,Debit
2025-04-18,Medical Store,Health,-7911,-2169380,Debit
2024-03-17,Movie Tickets,Entertainment,-3000,-2172380,Debit
2024-07-01,Petrol,Transport,-6968,-2179348,Debit
2024-09-09,Swiggy,Food,-4834,-2184182,Debit
2025-03-18,Interest Credit,Savings Interest,5790,-2178392,Credit
2024-10-18,Medical Store,Health,-108,-2178500,Debit
2025-05-08,Interest Credit,Savings Interest,25794,-2152706,Credit
2025-02-18,Spotify,Entertainment,-6789,-2159495,Debit
2025-04-26,Electronics,Shopping,-9168,-2168663,Debit
2024-11-06,ATM Withdrawal,Cash,-4849,-2173512,Debit
2024-05-15,Salary Credit,Income,7940,-2165572,Credit
2024-01-01,Flipkart Order,Shopping,-1258,-2166830,Debit
2024-08-18,Uber Ride,Transport,-3250,-2170080,Debit
2025-01-20,Bonus,Income,17893,-2152187,Credit
2024-06-24,Internet Recharge,Utilities,-6756,-2158943,Debit
2024-08-08,Swiggy,Food,-922,-2159865,Debit
2024-10-13,Freelance Payment,Income,10088,-2149777,Credit
2024-05-16,Bonus,Income,3057,-2146720,Credit
2024-07-08,ATM Withdrawal,Cash,-1037,-2147757,Debit
2025-02-21,Doctor Visit,Health,-8101,-2155858,Debit
2025-04-12,Movie Tickets,Entertainment,-6044,-2161902,Debit
2024-08-25,Doctor Visit,Health,-7787,-2169689,Debit
2024-09-09,Zomato Order,Food,-5357,-2175046,Debit
2024-09-05,ATM Withdrawal,Cash,-3312,-2178358,Debit
2024-04-27,ATM Withdrawal,Cash,-430,-2178788,Debit
2025-02-21,ATM Withdrawal,Cash,-4732,-2183520,Debit
2024-01-18,Salary Credit,Income,2578,-2180942,Credit
2024-12-17,ATM Withdrawal,Cash,-4147,-2185089,Debit
2024-12-11,Cash Deposit,Cash,-1280,-2186369,Debit
2024-06-07,Train Ticket,Transport,-3695,-2190064,Debit
2024-12-11,Refund,Income,28165,-2161899,Credit
2025-03-05,Interest Credit,Savings Interest,11231,-2150668,Credit
2024-04-24,Bank Transfer,Transfer,-4098,-2154766,Debit
2024-07-11,Spotify,Entertainment,-7058,-2161824,Debit
2024-10-31,Restaurant Bill,Food,-1119,-2162943,Debit
2024-03-07,Internet Recharge,Utilities,-4722,-2167665,Debit
2024-08-01,Water Bill,Utilities,-2531,-2170196,Debit
2025-04-12,Freelance Payment,Income,17111,-2153085,Credit
2024-03-29,Amazon Purchase,Shopping,-6956,-2160041,Debit
2025-01-08,Flipkart Order,Shopping,-207,-2160248,Debit
2025-03-16,Movie Tickets,Entertainment,-6550,-2166798,Debit
2024-07-11,Movie Tickets,Entertainment,-696,-2167494,Debit
2024-09-06,Water Bill,Utilities,-6349,-2173843,Debit
2025-03-12,UPI to Friend,Transfer,-559,-2174402,Debit
2025-04-24,Uber Ride,Transport,-9392,-2183794,Debit
2024-12-08,Water Bill,Utilities,-8121,-2191915,Debit
2024-06-24,Freelance Payment,Income,20181,-2171734,Credit
2025-02-03,Electronics,Shopping,-130,-2171864,Debit
2025-03-05,Internet Recharge,Utilities,-4700,-2176564,Debit
2024-09-11,Water Bill,Utilities,-5861,-2182425,Debit
2024-08-08,UPI to Friend,Transfer,-3924,-2186349,Debit
2024-07-03,Bank Transfer,Transfer,-3253,-2189602,Debit
2024-12-11,Train Ticket,Transport,-4991,-2194593,Debit
2024-08-11,FD Interest,Savings Interest,19958,-2174635,Credit
2024-07-20,Internet Recharge,Utilities,-3081,-2177716,Debit
2024-03-02,Interest Credit,Savings Interest,28364,-2149352,Credit
2025-05-06,YouTube Premium,Entertainment,-4885,-2154237,Debit
2024-05-12,Water Bill,Utilities,-8886,-2163123,Debit
2024-12-22,Interest Credit,Savings Interest,9590,-2153533,Credit
2025-02-18,Flipkart Order,Shopping,-3681,-2157214,Debit
2024-09-14,FD Interest,Savings Interest,27755,-2129459,Credit
2024-03-17,ATM Withdrawal,Cash,-6797,-2136256,Debit
2024-08-14,YouTube Premium,Entertainment,-4389,-2140645,Debit
2024-10-14,Water Bill,Utilities,-5537,-2146182,Debit
2025-03-01,Internet Recharge,Utilities,-5407,-2151589,Debit
2024-02-02,Spotify,Entertainment,-7489,-2159078,Debit
2025-04-02,Electronics,Shopping,-9388,-2168466,Debit
2024-05-27,ATM Withdrawal,Cash,-5531,-2173997,Debit
2025-01-21,Train Ticket,Transport,-2572,-2176569,Debit
2025-04-14,YouTube Premium,Entertainment,-5622,-2182191,Debit
2025-05-01,Medical Store,Health,-1100,-2183291,Debit
2024-09-13,Interest Credit,Savings Interest,27691,-2155600,Credit
2025-03-05,Interest Credit,Savings Interest,27131,-2128469,Credit
2024-04-18,Internet Recharge,Utilities,-9035,-2137504,Debit
2024-10-06,Zomato Order,Food,-4788,-2142292,Debit
2025-03-12,Zomato Order,Food,-134,-2142426,Debit
2025-02-14,Bank Transfer,Transfer,-8115,-2150541,Debit
2024-05-18,Amazon Purchase,Shopping,-778,-2151319,Debit
2024-02-27,FD Interest,Savings Interest,616,-2150703,Credit
2024-07-17,Restaurant Bill,Food,-3176,-2153879,Debit
2024-06-22,Train Ticket,Transport,-206,-2154085,Debit
2025-05-12,Freelance Payment,Income,2541,-2151544,Credit
2024-02-19,Petrol,Transport,-5645,-2157189,Debit
2025-01-19,Medical Store,Health,-7926,-2165115,Debit
2024-06-16,Uber Ride,Transport,-7351,-2172466,Debit
2024-12-28,UPI to Friend,Transfer,-3132,-2175598,Debit
2025-05-01,Medical Store,Health,-7508,-2183106,Debit
2024-06-15,Spotify,Entertainment,-5941,-2189047,Debit
2025-02-27,Medical Store,Health,-8249,-2197296,Debit
2024-05-18,Bank Transfer,Transfer,-9423,-2206719,Debit
2025-04-01,Doctor Visit,Health,-5208,-2211927,Debit
2024-03-07,YouTube Premium,Entertainment,-5833,-2217760,Debit
2024-02-22,Cafe Coffee Day,Food,-4678,-2222438,Debit
2024-06-18,Water Bill,Utilities,-5981,-2228419,Debit
2024-03-14,Medical Store,Health,-6602,-2235021,Debit
2025-03-04,Movie Tickets,Entertainment,-8246,-2243267,Debit
2024-08-25,Movie Tickets,Entertainment,-7231,-2250498,Debit
2025-02-08,Amazon Purchase,Shopping,-1651,-2252149,Debit
2025-03-14,UPI to Friend,Transfer,-5049,-2257198,Debit
2025-03-18,FD Interest,Savings Interest,2989,-2254209,Credit
2024-10-02,Cash Deposit,Cash,-3879,-2258088,Debit
2024-04-15,Petrol,Transport,-887,-2258975,Debit
2025-03-31,Interest Credit,Savings Interest,13641,-2245334,Credit
2024-11-16,Swiggy,Food,-792,-2246126,Debit
2024-11-10,Salary Credit,Income,20857,-2225269,Credit
2024-01-07,Flipkart Order,Shopping,-1196,-2226465,Debit
2024-05-03,Uber Ride,Transport,-3812,-2230277,Debit
2024-06-17,Electricity Bill,Utilities,-4760,-2235037,Debit
2024-11-14,ATM Withdrawal,Cash,-9856,-2244893,Debit
2025-02-15,Cash Deposit,Cash,-8540,-2253433,Debit
2024-01-25,Medical Store,Health,-6175,-2259608,Debit
2024-09-06,FD Interest,Savings Interest,11715,-2247893,Credit
2024-11-07,YouTube Premium,Entertainment,-6476,-2254369,Debit
2025-04-29,Medical Store,Health,-463,-2254832,Debit
2024-09-21,Electricity Bill,Utilities,-4084,-2258916,Debit
2025-02-22,Myntra Shopping,Shopping,-2549,-2261465,Debit
2024-01-30,Doctor Visit,Health,-2088,-2263553,Debit
2024-01-12,Bonus,Income,13503,-2250050,Credit
2024-11-21,Cafe Coffee Day,Food,-1248,-2251298,Debit
2024-01-22,Movie Tickets,Entertainment,-1918,-2253216,Debit
2025-01-07,UPI to Friend,Transfer,-2832,-2256048,Debit
2024-03-14,FD Interest,Savings Interest,7195,-2248853,Credit
2024-02-04,Electronics,Shopping,-368,-2249221,Debit
2024-09-18,Train Ticket,Transport,-3095,-2252316,Debit
2025-01-20,FD Interest,Savings Interest,1868,-2250448,Credit
2024-02-19,Received from Rahul,Transfer,-8244,-2258692,Debit
2024-11-16,Petrol,Transport,-347,-2259039,Debit
2024-04-03,Myntra Shopping,Shopping,-6303,-2265342,Debit
2024-02-24,Bank Transfer,Transfer,-1381,-2266723,Debit
2024-07-19,UPI to Friend,Transfer,-6823,-2273546,Debit
2025-02-05,Cash Deposit,Cash,-4877,-2278423,Debit
2025-03-01,Interest Credit,Savings Interest,12822,-2265601,Credit
2024-06-20,Spotify,Entertainment,-3079,-2268680,Debit
2024-06-07,Salary Credit,Income,6282,-2262398,Credit
2024-03-24,Zomato Order,Food,-187,-2262585,Debit
2025-04-07,Restaurant Bill,Food,-9117,-2271702,Debit
2024-10-28,Salary Credit,Income,22925,-2248777,Credit
2025-02-14,Water Bill,Utilities,-4977,-2253754,Debit
2024-11-14,ATM Withdrawal,Cash,-6684,-2260438,Debit
2024-05-30,FD Interest,Savings Interest,11337,-2249101,Credit
2025-01-26,Amazon Purchase,Shopping,-4240,-2253341,Debit
2024-10-31,Cash Deposit,Cash,-1370,-2254711,Debit
2024-09-13,Bank Transfer,Transfer,-4966,-2259677,Debit
2024-06-24,Interest Credit,Savings Interest,18998,-2240679,Credit
2024-05-14,Refund,Income,18706,-2221973,Credit
2025-01-06,Electronics,Shopping,-5828,-2227801,Debit
2025-02-23,Uber Ride,Transport,-3852,-2231653,Debit
2024-09-11,Cash Deposit,Cash,-5987,-2237640,Debit
2024-06-06,Restaurant Bill,Food,-9311,-2246951,Debit
2024-01-25,Zomato Order,Food,-3771,-2250722,Debit
2024-08-28,Uber Ride,Transport,-2411,-2253133,Debit
2024-12-14,Internet Recharge,Utilities,-8577,-2261710,Debit
2024-02-27,Doctor Visit,Health,-4307,-2266017,Debit
2025-03-01,FD Interest,Savings Interest,4132,-2261885,Credit
2024-03-10,ATM Withdrawal,Cash,-3027,-2264912,Debit
2024-05-16,Received from Rahul,Transfer,-5761,-2270673,Debit
2024-04-06,Amazon Purchase,Shopping,-1026,-2271699,Debit
2024-02-24,FD Interest,Savings Interest,28741,-2242958,Credit
2024-08-03,ATM Withdrawal,Cash,-1355,-2244313,Debit
2025-03-28,Freelance Payment,Income,18146,-2226167,Credit
2024-04-07,Water Bill,Utilities,-5549,-2231716,Debit
2025-01-09,Myntra Shopping,Shopping,-5729,-2237445,Debit
2025-01-11,Spotify,Entertainment,-9354,-2246799,Debit
2025-03-18,Petrol,Transport,-4907,-2251706,Debit
2024-02-02,Electronics,Shopping,-2505,-2254211,Debit
2024-05-29,YouTube Premium,Entertainment,-5443,-2259654,Debit
2024-05-02,Spotify,Entertainment,-9456,-2269110,Debit
2025-03-22,Flipkart Order,Shopping,-5169,-2274279,Debit
2025-03-22,Doctor Visit,Health,-3889,-2278168,Debit
2025-03-29,UPI to Friend,Transfer,-5984,-2284152,Debit
2025-04-20,Bank Transfer,Transfer,-5035,-2289187,Debit
2024-11-05,Electronics,Shopping,-3020,-2292207,Debit
2024-06-30,Movie Tickets,Entertainment,-4034,-2296241,Debit
2025-01-29,Train Ticket,Transport,-6113,-2302354,Debit
2024-06-19,ATM Withdrawal,Cash,-8622,-2310976,Debit
2024-05-02,Amazon Purchase,Shopping,-9305,-2320281,Debit
2025-02-20,Spotify,Entertainment,-9469,-2329750,Debit
2024-05-26,FD Interest,Savings Interest,4102,-2325648,Credit
2025-01-11,Uber Ride,Transport,-8653,-2334301,Debit
2025-01-14,FD Interest,Savings Interest,26548,-2307753,Credit
2025-03-23,UPI to Friend,Transfer,-5141,-2312894,Debit
2025-04-17,Salary Credit,Income,19251,-2293643,Credit
2024-07-04,Amazon Purchase,Shopping,-4772,-2298415,Debit
2024-06-04,ATM Withdrawal,Cash,-6821,-2305236,Debit
2024-12-30,ATM Withdrawal,Cash,-2628,-2307864,Debit
2024-02-20,Petrol,Transport,-4156,-2312020,Debit
2024-01-04,Zomato Order,Food,-9736,-2321756,Debit
2024-09-09,Medical Store,Health,-1223,-2322979,Debit
2024-02-15,YouTube Premium,Entertainment,-6651,-2329630,Debit
2024-07-21,Train Ticket,Transport,-2672,-2332302,Debit
2024-05-08,Medical Store,Health,-9136,-2341438,Debit
2025-04-21,Myntra Shopping,Shopping,-3534,-2344972,Debit
2024-05-10,Train Ticket,Transport,-4513,-2349485,Debit
2024-12-22,Zomato Order,Food,-296,-2349781,Debit
2024-05-14,Cafe Coffee Day,Food,-2201,-2351982,Debit
2024-08-06,Water Bill,Utilities,-4216,-2356198,Debit
2024-03-09,Medical Store,Health,-8758,-2364956,Debit
2025-03-09,Medical Store,Health,-2084,-2367040,Debit
2024-10-28,Bank Transfer,Transfer,-1364,-2368404,Debit
2024-09-30,UPI to Friend,Transfer,-9441,-2377845,Debit
2025-04-05,ATM Withdrawal,Cash,-3792,-2381637,Debit
2024-11-02,Medical Store,Health,-6750,-2388387,Debit
2024-05-29,Interest Credit,Savings Interest,21314,-2367073,Credit
2024-02-23,Medical Store,Health,-614,-2367687,Debit
2024-08-29,Received from Rahul,Transfer,-2175,-2369862,Debit
2024-07-07,Medical Store,Health,-5118,-2374980,Debit
2025-04-06,Interest Credit,Savings Interest,2696,-2372284,Credit
2024-02-18,FD Interest,Savings Interest,2940,-2369344,Credit
2024-01-20,Interest Credit,Savings Interest,3638,-2365706,Credit
2024-12-01,Train Ticket,Transport,-2967,-2368673,Debit
2024-12-01,Freelance Payment,Income,4735,-2363938,Credit
2024-01-17,Refund,Income,21397,-2342541,Credit
2024-09-28,Internet Recharge,Utilities,-445,-2342986,Debit
2024-09-08,Myntra Shopping,Shopping,-1510,-2344496,Debit
2024-03-19,Medical Store,Health,-8822,-2353318,Debit
2024-06-29,UPI to Friend,Transfer,-4758,-2358076,Debit
2024-11-30,Received from Rahul,Transfer,-6131,-2364207,Debit
2024-03-07,Internet Recharge,Utilities,-4064,-2368271,Debit
2025-05-05,Flipkart Order,Shopping,-5936,-2374207,Debit
2024-03-09,Train Ticket,Transport,-8878,-2383085,Debit
2024-03-06,Water Bill,Utilities,-8574,-2391659,Debit
2024-06-25,YouTube Premium,Entertainment,-4599,-2396258,Debit
2024-01-17,Train Ticket,Transport,-8580,-2404838,Debit
2024-11-03,Doctor Visit,Health,-3353,-2408191,Debit
2025-01-04,Interest Credit,Savings Interest,19827,-2388364,Credit
2024-07-08,ATM Withdrawal,Cash,-9211,-2397575,Debit
2025-03-28,FD Interest,Savings Interest,14409,-2383166,Credit
2025-04-07,ATM Withdrawal,Cash,-4209,-2387375,Debit
2024-03-28,Uber Ride,Transport,-8737,-2396112,Debit
2024-08-05,Electricity Bill,Utilities,-6349,-2402461,Debit
2024-06-09,Bank Transfer,Transfer,-2157,-2404618,Debit
2024-10-25,Spotify,Entertainment,-2942,-2407560,Debit
2024-05-29,Bonus,Income,23786,-2383774,Credit
2024-11-24,Bonus,Income,19150,-2364624,Credit
2024-01-06,Petrol,Transport,-5951,-2370575,Debit
2024-03-28,Cash Deposit,Cash,-8023,-2378598,Debit
2024-02-05,FD Interest,Savings Interest,20296,-2358302,Credit
2025-01-13,FD Interest,Savings Interest,9566,-2348736,Credit
2024-12-29,Uber Ride,Transport,-9526,-2358262,Debit
2024-09-29,ATM Withdrawal,Cash,-335,-2358597,Debit
2024-11-03,Spotify,Entertainment,-7040,-2365637,Debit
2024-02-08,Cash Deposit,Cash,-4213,-2369850,Debit
2024-12-18,YouTube Premium,Entertainment,-6052,-2375902,Debit
2024-01-01,Interest Credit,Savings Interest,2062,-2373840,Credit
2024-06-01,Amazon Purchase,Shopping,-8028,-2381868,Debit
2025-04-29,Train Ticket,Transport,-2472,-2384340,Debit
2025-02-10,Electricity Bill,Utilities,-5975,-2390315,Debit
2024-08-28,YouTube Premium,Entertainment,-6720,-2397035,Debit
2024-08-27,Swiggy,Food,-4627,-2401662,Debit
2024-10-29,Internet Recharge,Utilities,-7375,-2409037,Debit
2025-03-29,Movie Tickets,Entertainment,-4871,-2413908,Debit
2024-02-13,Medical Store,Health,-6352,-2420260,Debit
2024-11-21,Internet Recharge,Utilities,-6545,-2426805,Debit
2024-03-02,Cash Deposit,Cash,-954,-2427759,Debit
2025-01-10,Swiggy,Food,-4204,-2431963,Debit
2024-01-13,Cafe Coffee Day,Food,-1507,-2433470,Debit
2025-03-27,Spotify,Entertainment,-3672,-2437142,Debit
2024-06-19,UPI to Friend,Transfer,-7514,-2444656,Debit
2024-04-04,Train Ticket,Transport,-5843,-2450499,Debit
2025-04-27,Salary Credit,Income,29093,-2421406,Credit
2024-09-30,Bonus,Income,22010,-2399396,Credit
2025-02-10,Salary Credit,Income,15157,-2384239,Credit
2024-01-19,Zomato Order,Food,-5135,-2389374,Debit
2024-03-09,Bonus,Income,17096,-2372278,Credit
2024-11-22,Zomato Order,Food,-3954,-2376232,Debit
2025-05-03,Zomato Order,Food,-3448,-2379680,Debit
2024-07-01,Refund,Income,23823,-2355857,Credit
2024-01-20,YouTube Premium,Entertainment,-9597,-2365454,Debit
2025-04-25,Uber Ride,Transport,-3713,-2369167,Debit
2024-12-07,FD Interest,Savings Interest,24483,-2344684,Credit
2024-05-14,Water Bill,Utilities,-8551,-2353235,Debit
2025-01-13,UPI to Friend,Transfer,-4374,-2357609,Debit
2025-02-01,FD Interest,Savings Interest,935,-2356674,Credit
2024-10-17,ATM Withdrawal,Cash,-1815,-2358489,Debit
2024-09-04,YouTube Premium,Entertainment,-5749,-2364238,Debit
2024-01-09,Restaurant Bill,Food,-6989,-2371227,Debit
2025-04-26,Internet Recharge,Utilities,-522,-2371749,Debit
2024-01-14,Bank Transfer,Transfer,-7873,-2379622,Debit
2024-05-31,Salary Credit,Income,3183,-2376439,Credit
2025-05-05,Interest Credit,Savings Interest,17274,-2359165,Credit
2025-04-15,Spotify,Entertainment,-7290,-2366455,Debit
2025-03-11,ATM Withdrawal,Cash,-7407,-2373862,Debit
2024-07-26,Zomato Order,Food,-5904,-2379766,Debit
2024-11-30,Swiggy,Food,-2662,-2382428,Debit
2024-10-15,Movie Tickets,Entertainment,-1200,-2383628,Debit
2024-11-20,FD Interest,Savings Interest,9593,-2374035,Credit
2024-05-25,Myntra Shopping,Shopping,-867,-2374902,Debit
2025-04-15,ATM Withdrawal,Cash,-8043,-2382945,Debit
2024-01-05,Medical Store,Health,-767,-2383712,Debit
2024-10-21,Electricity Bill,Utilities,-7011,-2390723,Debit
2024-01-17,Cash Deposit,Cash,-3424,-2394147,Debit
2024-06-07,Internet Recharge,Utilities,-7763,-2401910,Debit
2025-02-26,Bonus,Income,9041,-2392869,Credit
2024-03-21,Bank Transfer,Transfer,-8978,-2401847,Debit
2024-06-04,Spotify,Entertainment,-7613,-2409460,Debit
2024-02-01,FD Interest,Savings Interest,10871,-2398589,Credit
2024-11-01,Spotify,Entertainment,-3731,-2402320,Debit
2025-02-18,Uber Ride,Transport,-4044,-2406364,Debit
2024-06-06,Cafe Coffee Day,Food,-2713,-2409077,Debit
2024-05-09,Interest Credit,Savings Interest,11611,-2397466,Credit
2025-01-19,Received from Rahul,Transfer,-9360,-2406826,Debit
2024-08-16,Spotify,Entertainment,-358,-2407184,Debit
2024-01-27,Movie Tickets,Entertainment,-2957,-2410141,Debit
2024-02-01,Received from Rahul,Transfer,-1635,-2411776,Debit
2024-07-13,FD Interest,Savings Interest,22130,-2389646,Credit
2025-03-11,FD Interest,Savings Interest,19398,-2370248,Credit
2024-09-15,Uber Ride,Transport,-2907,-2373155,Debit
2024-07-18,Flipkart Order,Shopping,-1055,-2374210,Debit
2024-12-17,Uber Ride,Transport,-2328,-2376538,Debit
2025-01-25,FD Interest,Savings Interest,10998,-2365540,Credit
2025-04-01,FD Interest,Savings Interest,5665,-2359875,Credit
2024-06-08,Train Ticket,Transport,-5726,-2365601,Debit
2024-07-05,UPI to Friend,Transfer,-5555,-2371156,Debit
2024-01-14,Doctor Visit,Health,-355,-2371511,Debit
2025-01-26,Amazon Purchase,Shopping,-1848,-2373359,Debit
2024-07-01,Internet Recharge,Utilities,-4726,-2378085,Debit
2024-10-25,ATM Withdrawal,Cash,-9711,-2387796,Debit
2024-08-12,Movie Tickets,Entertainment,-7893,-2395689,Debit
2024-10-23,Medical Store,Health,-7768,-2403457,Debit
2024-06-24,Water Bill,Utilities,-659,-2404116,Debit
2024-07-02,Water Bill,Utilities,-766,-2404882,Debit
2024-10-28,ATM Withdrawal,Cash,-122,-2405004,Debit
2025-01-19,YouTube Premium,Entertainment,-5484,-2410488,Debit
2025-04-25,Spotify,Entertainment,-6525,-2417013,Debit
2024-08-14,Swiggy,Food,-1913,-2418926,Debit
2025-01-07,Cafe Coffee Day,Food,-8616,-2427542,Debit
2025-03-11,YouTube Premium,Entertainment,-9934,-2437476,Debit
2024-02-03,Spotify,Entertainment,-3037,-2440513,Debit
2024-07-07,Cash Deposit,Cash,-2841,-2443354,Debit
2024-07-22,Zomato Order,Food,-1711,-2445065,Debit
2024-11-26,Cash Deposit,Cash,-4452,-2449517,Debit
2025-01-06,UPI to Friend,Transfer,-1774,-2451291,Debit
2024-08-22,Petrol,Transport,-9682,-2460973,Debit
2024-08-24,Flipkart Order,Shopping,-1663,-2462636,Debit
2024-04-02,Received from Rahul,Transfer,-702,-2463338,Debit
2024-07-06,Doctor Visit,Health,-6685,-2470023,Debit
2024-04-25,Movie Tickets,Entertainment,-677,-2470700,Debit
2025-01-16,Water Bill,Utilities,-2253,-2472953,Debit
2025-03-23,Interest Credit,Savings Interest,1287,-2471666,Credit
2024-10-30,Train Ticket,Transport,-7184,-2478850,Debit
2025-03-19,ATM Withdrawal,Cash,-8571,-2487421,Debit
2025-02-21,Amazon Purchase,Shopping,-9862,-2497283,Debit
2024-08-27,Movie Tickets,Entertainment,-8635,-2505918,Debit
2024-06-03,Train Ticket,Transport,-276,-2506194,Debit
2024-09-19,Internet Recharge,Utilities,-5239,-2511433,Debit
2024-02-10,Movie Tickets,Entertainment,-7636,-2519069,Debit
2024-11-22,Petrol,Transport,-8593,-2527662,Debit
2024-07-30,Water Bill,Utilities,-6052,-2533714,Debit
2024-08-24,Refund,Income,7410,-2526304,Credit
2024-06-21,Spotify,Entertainment,-4151,-2530455,Debit
2025-04-06,Cafe Coffee Day,Food,-8053,-2538508,Debit
2024-08-03,Refund,Income,8223,-2530285,Credit
2025-04-01,FD Interest,Savings Interest,6443,-2523842,Credit
2025-01-29,Internet Recharge,Utilities,-1481,-2525323,Debit
2024-07-13,Salary Credit,Income,7135,-2518188,Credit
2024-06-11,Cash Deposit,Cash,-1017,-2519205,Debit
2024-04-05,Petrol,Transport,-9539,-2528744,Debit
2024-10-19,Restaurant Bill,Food,-7887,-2536631,Debit
2025-03-27,Water Bill,Utilities,-336,-2536967,Debit
2024-08-09,Freelance Payment,Income,29145,-2507822,Credit
2025-05-02,YouTube Premium,Entertainment,-4832,-2512654,Debit
2024-01-14,Interest Credit,Savings Interest,3491,-2509163,Credit
2025-03-09,Received from Rahul,Transfer,-1006,-2510169,Debit
2025-04-29,Electricity Bill,Utilities,-7195,-2517364,Debit
2024-08-13,UPI to Friend,Transfer,-2959,-2520323,Debit
2024-11-23,Medical Store,Health,-9976,-2530299,Debit
2025-04-24,Interest Credit,Savings Interest,19105,-2511194,Credit
2024-10-19,Medical Store,Health,-2868,-2514062,Debit
2025-03-09,Electricity Bill,Utilities,-9219,-2523281,Debit
2024-11-14,Water Bill,Utilities,-1265,-2524546,Debit
2024-01-17,Train Ticket,Transport,-9815,-2534361,Debit
2025-02-07,Movie Tickets,Entertainment,-1486,-2535847,Debit
2024-02-23,Electronics,Shopping,-1587,-2537434,Debit
2024-10-17,Water Bill,Utilities,-2305,-2539739,Debit
2024-03-23,Internet Recharge,Utilities,-7646,-2547385,Debit
2024-06-05,Bank Transfer,Transfer,-6142,-2553527,Debit
2024-06-01,Zomato Order,Food,-4794,-2558321,Debit
2025-02-24,Doctor Visit,Health,-4614,-2562935,Debit
2024-06-12,Received from Rahul,Transfer,-2464,-2565399,Debit
2024-04-15,Flipkart Order,Shopping,-7911,-2573310,Debit
2024-08-16,Myntra Shopping,Shopping,-4913,-2578223,Debit
2024-10-21,UPI to Friend,Transfer,-8231,-2586454,Debit
2024-11-11,Interest Credit,Savings Interest,21020,-2565434,Credit
2024-05-04,Train Ticket,Transport,-4346,-2569780,Debit
2024-09-06,Electronics,Shopping,-1903,-2571683,Debit
2024-03-30,Electronics,Shopping,-7870,-2579553,Debit
2024-04-15,Medical Store,Health,-2802,-2582355,Debit
2024-01-20,Internet Recharge,Utilities,-5271,-2587626,Debit
2024-11-13,ATM Withdrawal,Cash,-4647,-2592273,Debit
2024-11-29,Cash Deposit,Cash,-7277,-2599550,Debit
2024-12-07,Refund,Income,6736,-2592814,Credit
2024-08-19,Medical Store,Health,-140,-2592954,Debit
2025-04-30,Train Ticket,Transport,-6430,-2599384,Debit
2025-03-16,Petrol,Transport,-6224,-2605608,Debit
2025-05-14,YouTube Premium,Entertainment,-574,-2606182,Debit
2025-04-18,Swiggy,Food,-7452,-2613634,Debit
2024-03-10,Uber Ride,Transport,-3209,-2616843,Debit
2024-08-30,Bank Transfer,Transfer,-4518,-2621361,Debit
2024-01-11,Swiggy,Food,-1154,-2622515,Debit
2024-02-02,YouTube Premium,Entertainment,-3759,-2626274,Debit
2025-01-18,Bonus,Income,27720,-2598554,Credit
2024-02-02,Water Bill,Utilities,-9526,-2608080,Debit
2024-01-22,Myntra Shopping,Shopping,-2577,-2610657,Debit
2024-01-02,Cash Deposit,Cash,-3547,-2614204,Debit
2024-06-02,Amazon Purchase,Shopping,-671,-2614875,Debit
2024-08-14,Movie Tickets,Entertainment,-6989,-2621864,Debit
2024-09-11,Flipkart Order,Shopping,-4834,-2626698,Debit
2024-04-07,YouTube Premium,Entertainment,-6829,-2633527,Debit
2024-08-23,Cash Deposit,Cash,-974,-2634501,Debit
2025-01-06,Medical Store,Health,-7985,-2642486,Debit
2025-03-18,Freelance Payment,Income,23346,-2619140,Credit
2024-01-13,Medical Store,Health,-4183,-2623323,Debit
2025-04-04,Zomato Order,Food,-5558,-2628881,Debit
2025-03-24,Salary Credit,Income,7815,-2621066,Credit
2024-05-04,Interest Credit,Savings Interest,20557,-2600509,Credit
2024-09-26,Electronics,Shopping,-9611,-2610120,Debit
2025-01-27,Doctor Visit,Health,-4293,-2614413,Debit
2024-03-01,Doctor Visit,Health,-7602,-2622015,Debit
2024-01-13,Medical Store,Health,-8825,-2630840,Debit
2024-01-14,Spotify,Entertainment,-7700,-2638540,Debit
2024-05-15,FD Interest,Savings Interest,20343,-2618197,Credit
2024-08-27,ATM Withdrawal,Cash,-2673,-2620870,Debit
2024-06-02,Water Bill,Utilities,-9448,-2630318,Debit
2024-11-17,Water Bill,Utilities,-4042,-2634360,Debit
2024-02-10,Spotify,Entertainment,-9423,-2643783,Debit
2024-06-09,Amazon Purchase,Shopping,-9861,-2653644,Debit
2024-01-29,Received from Rahul,Transfer,-5627,-2659271,Debit
2025-01-26,Interest Credit,Savings Interest,15959,-2643312,Credit
2024-10-16,Interest Credit,Savings Interest,6269,-2637043,Credit
2024-09-26,Amazon Purchase,Shopping,-6326,-2643369,Debit
2025-04-28,Electricity Bill,Utilities,-471,-2643840,Debit
2024-02-20,Refund,Income,17431,-2626409,Credit
2024-11-16,Swiggy,Food,-5711,-2632120,Debit
2024-03-01,Cash Deposit,Cash,-8667,-2640787,Debit
2025-01-04,Medical Store,Health,-6862,-2647649,Debit
2024-05-21,Flipkart Order,Shopping,-5901,-2653550,Debit
2024-10-09,Interest Credit,Savings Interest,19158,-2634392,Credit
2024-11-06,Uber Ride,Transport,-5770,-2640162,Debit
2024-09-21,Movie Tickets,Entertainment,-3635,-2643797,Debit
2024-11-22,Freelance Payment,Income,19242,-2624555,Credit
2024-12-14,Myntra Shopping,Shopping,-2608,-2627163,Debit
2025-01-15,Salary Credit,Income,10318,-2616845,Credit
2024-12-11,Freelance Payment,Income,538,-2616307,Credit
2025-03-18,Uber Ride,Transport,-6943,-2623250,Debit
2024-02-21,Electricity Bill,Utilities,-727,-2623977,Debit
2024-03-14,ATM Withdrawal,Cash,-3290,-2627267,Debit
2025-03-25,YouTube Premium,Entertainment,-746,-2628013,Debit
2024-10-16,Electronics,Shopping,-6798,-2634811,Debit
2024-05-22,FD Interest,Savings Interest,22097,-2612714,Credit
2024-03-24,Electricity Bill,Utilities,-8060,-2620774,Debit
2025-02-05,ATM Withdrawal,Cash,-4042,-2624816,Debit
2024-01-10,Bank Transfer,Transfer,-3897,-2628713,Debit
2024-12-10,Water Bill,Utilities,-666,-2629379,Debit
2024-03-27,Medical Store,Health,-2364,-2631743,Debit
2024-04-19,Train Ticket,Transport,-1931,-2633674,Debit
2024-11-12,Myntra Shopping,Shopping,-4131,-2637805,Debit
2024-10-10,Electricity Bill,Utilities,-5519,-2643324,Debit
2024-12-14,Flipkart Order,Shopping,-6892,-2650216,Debit
2024-01-15,Spotify,Entertainment,-3392,-2653608,Debit
2025-04-30,Medical Store,Health,-5272,-2658880,Debit
2024-03-12,Swiggy,Food,-4272,-2663152,Debit
2024-10-27,Medical Store,Health,-930,-2664082,Debit
2024-04-08,UPI to Friend,Transfer,-8277,-2672359,Debit
2024-06-25,YouTube Premium,Entertainment,-6900,-2679259,Debit
2024-07-25,Petrol,Transport,-8423,-2687682,Debit
2024-09-20,Internet Recharge,Utilities,-6539,-2694221,Debit
2024-03-27,Medical Store,Health,-2454,-2696675,Debit
2024-02-08,YouTube Premium,Entertainment,-5926,-2702601,Debit
2024-02-19,Refund,Income,29820,-2672781,Credit
2024-07-11,Swiggy,Food,-5271,-2678052,Debit
2024-11-14,Interest Credit,Savings Interest,11712,-2666340,Credit
2024-08-28,Bonus,Income,28457,-2637883,Credit
2025-03-11,Bonus,Income,7213,-2630670,Credit
2024-10-16,Medical Store,Health,-1986,-2632656,Debit
2024-10-01,YouTube Premium,Entertainment,-7417,-2640073,Debit
2024-04-16,Interest Credit,Savings Interest,14627,-2625446,Credit
2025-05-07,Train Ticket,Transport,-9993,-2635439,Debit
2024-05-22,Zomato Order,Food,-6518,-2641957,Debit
2024-08-01,Doctor Visit,Health,-5519,-2647476,Debit
2024-03-13,Electronics,Shopping,-4623,-2652099,Debit
2024-02-06,Train Ticket,Transport,-6220,-2658319,Debit
2024-01-18,Medical Store,Health,-6986,-2665305,Debit
2024-03-20,Doctor Visit,Health,-1457,-2666762,Debit
2025-01-31,Cash Deposit,Cash,-7967,-2674729,Debit
2024-05-06,FD Interest,Savings Interest,25887,-2648842,Credit
2024-03-08,Movie Tickets,Entertainment,-8825,-2657667,Debit
2024-03-21,Interest Credit,Savings Interest,23968,-2633699,Credit
2024-03-04,Salary Credit,Income,29296,-2604403,Credit
2024-02-28,Electronics,Shopping,-6568,-2610971,Debit
2025-03-07,Restaurant Bill,Food,-194,-2611165,Debit
2024-08-02,FD Interest,Savings Interest,11763,-2599402,Credit
2024-06-21,Electronics,Shopping,-8958,-2608360,Debit
2024-10-15,Interest Credit,Savings Interest,5005,-2603355,Credit
2024-10-05,Petrol,Transport,-6016,-2609371,Debit
2024-06-15,Electricity Bill,Utilities,-8838,-2618209,Debit
2024-12-25,Train Ticket,Transport,-6718,-2624927,Debit
2025-02-28,Uber Ride,Transport,-3644,-2628571,Debit
2024-05-03,Swiggy,Food,-2406,-2630977,Debit
2024-02-27,Cash Deposit,Cash,-6152,-2637129,Debit
2024-05-05,FD Interest,Savings Interest,16180,-2620949,Credit
2024-07-20,Swiggy,Food,-1924,-2622873,Debit
2025-04-30,Salary Credit,Income,15850,-2607023,Credit
2025-04-23,UPI to Friend,Transfer,-9019,-2616042,Debit
2025-01-01,Uber Ride,Transport,-8578,-2624620,Debit
2024-03-11,Movie Tickets,Entertainment,-7792,-2632412,Debit
2024-02-07,Swiggy,Food,-6260,-2638672,Debit
2024-12-30,Uber Ride,Transport,-4594,-2643266,Debit
2024-02-02,Water Bill,Utilities,-2721,-2645987,Debit
2024-03-16,Doctor Visit,Health,-5939,-2651926,Debit
2025-03-27,Received from Rahul,Transfer,-4934,-2656860,Debit
2024-02-21,Electronics,Shopping,-7459,-2664319,Debit
2024-04-20,Movie Tickets,Entertainment,-6578,-2670897,Debit
2024-12-04,Flipkart Order,Shopping,-2949,-2673846,Debit
2025-02-06,Zomato Order,Food,-9220,-2683066,Debit
2024-08-31,Amazon Purchase,Shopping,-5890,-2688956,Debit
2025-03-07,Doctor Visit,Health,-760,-2689716,Debit
2024-12-09,FD Interest,Savings Interest,22213,-2667503,Credit
2024-11-18,Interest Credit,Savings Interest,5573,-2661930,Credit
2024-12-16,YouTube Premium,Entertainment,-1194,-2663124,Debit
2024-02-15,ATM Withdrawal,Cash,-352,-2663476,Debit
2024-10-01,Medical Store,Health,-6139,-2669615,Debit
2024-08-23,Uber Ride,Transport,-8976,-2678591,Debit
2024-01-23,ATM Withdrawal,Cash,-1454,-2680045,Debit
2024-12-01,ATM Withdrawal,Cash,-5025,-2685070,Debit
2025-04-04,Refund,Income,991,-2684079,Credit
2024-11-20,Freelance Payment,Income,3564,-2680515,Credit
2024-10-19,Uber Ride,Transport,-9460,-2689975,Debit
2024-10-15,Bonus,Income,20021,-2669954,Credit
2024-07-11,Train Ticket,Transport,-7518,-2677472,Debit
2024-11-11,Zomato Order,Food,-2890,-2680362,Debit
2024-06-27,Water Bill,Utilities,-8495,-2688857,Debit
2025-01-28,ATM Withdrawal,Cash,-2744,-2691601,Debit
2024-03-30,Salary Credit,Income,4623,-2686978,Credit
2024-08-16,Spotify,Entertainment,-4690,-2691668,Debit
2024-09-14,Bank Transfer,Transfer,-2169,-2693837,Debit
2024-08-18,Doctor Visit,Health,-1562,-2695399,Debit
2025-01-05,Interest Credit,Savings Interest,16624,-2678775,Credit
2025-05-02,Spotify,Entertainment,-2856,-2681631,Debit
2025-03-16,UPI to Friend,Transfer,-5162,-2686793,Debit
2025-05-02,Received from Rahul,Transfer,-4551,-2691344,Debit
2025-02-01,Flipkart Order,Shopping,-2662,-2694006,Debit
2024-05-21,Bonus,Income,9204,-2684802,Credit
2025-03-30,Interest Credit,Savings Interest,9233,-2675569,Credit
2024-06-30,YouTube Premium,Entertainment,-6524,-2682093,Debit
2024-09-24,Swiggy,Food,-5917,-2688010,Debit
2024-06-30,Zomato Order,Food,-1075,-2689085,Debit
2025-02-23,Medical Store,Health,-6782,-2695867,Debit
2024-05-24,Petrol,Transport,-1727,-2697594,Debit
2024-03-18,Internet Recharge,Utilities,-6643,-2704237,Debit
2024-05-24,Salary Credit,Income,18601,-2685636,Credit
2024-08-13,Petrol,Transport,-8562,-2694198,Debit
2024-05-17,Doctor Visit,Health,-2723,-2696921,Debit
2025-01-09,Received from Rahul,Transfer,-9262,-2706183,Debit
2024-12-09,Doctor Visit,Health,-7989,-2714172,Debit
2024-02-24,FD Interest,Savings Interest,4627,-2709545,Credit
2024-02-28,Petrol,Transport,-2705,-2712250,Debit
2025-02-06,Amazon Purchase,Shopping,-9829,-2722079,Debit
2024-06-11,Uber Ride,Transport,-5590,-2727669,Debit
2024-01-11,Interest Credit,Savings Interest,6123,-2721546,Credit
2024-07-28,Electronics,Shopping,-1527,-2723073,Debit
2024-04-23,Received from Rahul,Transfer,-4992,-2728065,Debit
2024-01-07,Petrol,Transport,-2564,-2730629,Debit
2024-06-30,Electricity Bill,Utilities,-4635,-2735264,Debit
2024-10-18,Medical Store,Health,-2040,-2737304,Debit
2024-01-25,Salary Credit,Income,18118,-2719186,Credit
2025-04-11,Electricity Bill,Utilities,-648,-2719834,Debit
2025-01-22,Bonus,Income,28021,-2691813,Credit
2025-05-11,Spotify,Entertainment,-1080,-2692893,Debit
2024-12-10,Swiggy,Food,-5131,-2698024,Debit
2025-02-18,UPI to Friend,Transfer,-7197,-2705221,Debit
2024-06-10,Received from Rahul,Transfer,-904,-2706125,Debit
2024-11-21,Zomato Order,Food,-5417,-2711542,Debit
2024-05-08,Doctor Visit,Health,-7121,-2718663,Debit
2024-06-09,FD Interest,Savings Interest,4956,-2713707,Credit
2025-02-02,Salary Credit,Income,3935,-2709772,Credit
2024-07-24,Internet Recharge,Utilities,-4301,-2714073,Debit
2024-03-30,Received from Rahul,Transfer,-9645,-2723718,Debit
2025-01-24,Petrol,Transport,-6313,-2730031,Debit
2025-01-16,Electricity Bill,Utilities,-1336,-2731367,Debit
2024-03-24,Bank Transfer,Transfer,-5029,-2736396,Debit
2024-08-29,YouTube Premium,Entertainment,-7744,-2744140,Debit
2025-02-28,Cash Deposit,Cash,-158,-2744298,Debit
2025-03-01,Petrol,Transport,-6644,-2750942,Debit
2025-05-12,Electricity Bill,Utilities,-6148,-2757090,Debit
2025-02-01,Cash Deposit,Cash,-9168,-2766258,Debit
2024-07-12,ATM Withdrawal,Cash,-9944,-2776202,Debit
2024-03-27,ATM Withdrawal,Cash,-7299,-2783501,Debit
2024-05-22,UPI to Friend,Transfer,-4275,-2787776,Debit
2024-02-16,Salary Credit,Income,16073,-2771703,Credit
2025-02-03,Internet Recharge,Utilities,-5209,-2776912,Debit
2024-02-08,FD Interest,Savings Interest,11815,-2765097,Credit
2025-03-26,Cash Deposit,Cash,-923,-2766020,Debit
2024-10-28,Medical Store,Health,-8366,-2774386,Debit
2024-09-05,Water Bill,Utilities,-692,-2775078,Debit
2025-02-26,Zomato Order,Food,-910,-2775988,Debit
2024-04-16,FD Interest,Savings Interest,28091,-2747897,Credit
2024-10-01,Electricity Bill,Utilities,-8635,-2756532,Debit
2024-04-09,ATM Withdrawal,Cash,-9249,-2765781,Debit
2024-06-21,ATM Withdrawal,Cash,-4642,-2770423,Debit
2024-09-20,Received from Rahul,Transfer,-8691,-2779114,Debit
2024-04-22,Train Ticket,Transport,-1009,-2780123,Debit
2024-12-17,ATM Withdrawal,Cash,-8108,-2788231,Debit
2024-10-08,Freelance Payment,Income,13008,-2775223,Credit
2024-01-29,UPI to Friend,Transfer,-5177,-2780400,Debit
2025-04-03,Freelance Payment,Income,26513,-2753887,Credit
2024-09-08,Bank Transfer,Transfer,-5554,-2759441,Debit
2024-08-01,Zomato Order,Food,-3913,-2763354,Debit
2024-03-24,Interest Credit,Savings Interest,6969,-2756385,Credit
2024-12-31,Train Ticket,Transport,-4059,-2760444,Debit
2024-04-12,Interest Credit,Savings Interest,1324,-2759120,Credit
2024-01-09,YouTube Premium,Entertainment,-9685,-2768805,Debit
2024-01-11,Interest Credit,Savings Interest,25944,-2742861,Credit
2024-01-05,Flipkart Order,Shopping,-4536,-2747397,Debit
2024-08-29,Refund,Income,26700,-2720697,Credit
2024-05-06,Flipkart Order,Shopping,-4896,-2725593,Debit
2025-03-01,Salary Credit,Income,14554,-2711039,Credit
2024-05-14,Cash Deposit,Cash,-2471,-2713510,Debit
2024-10-10,Freelance Payment,Income,4107,-2709403,Credit
2024-07-03,Uber Ride,Transport,-467,-2709870,Debit
2025-03-12,YouTube Premium,Entertainment,-7744,-2717614,Debit
2024-10-11,UPI to Friend,Transfer,-9386,-2727000,Debit
2024-12-23,Restaurant Bill,Food,-1740,-2728740,Debit
2024-08-09,Swiggy,Food,-6733,-2735473,Debit
2024-04-10,FD Interest,Savings Interest,10145,-2725328,Credit
2024-08-26,FD Interest,Savings Interest,24276,-2701052,Credit
2024-06-15,Electronics,Shopping,-5775,-2706827,Debit
2024-01-09,YouTube Premium,Entertainment,-9649,-2716476,Debit
2025-03-04,Flipkart Order,Shopping,-8390,-2724866,Debit
2024-06-27,Bank Transfer,Transfer,-2753,-2727619,Debit
2024-12-22,Interest Credit,Savings Interest,13194,-2714425,Credit
2024-05-23,Electronics,Shopping,-4363,-2718788,Debit
2024-11-02,Interest Credit,Savings Interest,17075,-2701713,Credit
2024-03-22,FD Interest,Savings Interest,8642,-2693071,Credit
2024-06-11,Interest Credit,Savings Interest,5115,-2687956,Credit
2025-03-07,ATM Withdrawal,Cash,-7105,-2695061,Debit
2024-09-30,Received from Rahul,Transfer,-6337,-2701398,Debit
2025-04-09,Bank Transfer,Transfer,-1640,-2703038,Debit
2024-08-09,Petrol,Transport,-4043,-2707081,Debit
2025-04-12,Spotify,Entertainment,-4323,-2711404,Debit
2024-10-17,Electronics,Shopping,-7514,-2718918,Debit
2025-03-05,Cafe Coffee Day,Food,-2886,-2721804,Debit
2025-03-10,Doctor Visit,Health,-6461,-2728265,Debit
2025-01-04,Doctor Visit,Health,-1998,-2730263,Debit
2024-02-29,Cash Deposit,Cash,-3491,-2733754,Debit
2025-01-21,YouTube Premium,Entertainment,-935,-2734689,Debit
2024-09-22,Doctor Visit,Health,-9070,-2743759,Debit
2024-09-10,YouTube Premium,Entertainment,-3872,-2747631,Debit
2025-01-06,Doctor Visit,Health,-8297,-2755928,Debit
2024-10-15,FD Interest,Savings Interest,21262,-2734666,Credit
2025-04-25,Cash Deposit,Cash,-7228,-2741894,Debit
2024-07-07,Medical Store,Health,-8116,-2750010,Debit
2025-03-30,Internet Recharge,Utilities,-6190,-2756200,Debit
2024-03-30,Received from Rahul,Transfer,-6234,-2762434,Debit
2025-01-16,YouTube Premium,Entertainment,-6674,-2769108,Debit
2024-01-21,FD Interest,Savings Interest,23160,-2745948,Credit
2025-03-05,Water Bill,Utilities,-1397,-2747345,Debit
2024-07-16,Cash Deposit,Cash,-7020,-2754365,Debit
2024-02-18,Train Ticket,Transport,-5110,-2759475,Debit
2025-01-13,Salary Credit,Income,4636,-2754839,Credit
2024-04-23,Flipkart Order,Shopping,-2412,-2757251,Debit
2025-04-17,Amazon Purchase,Shopping,-8755,-2766006,Debit
2024-03-19,Internet Recharge,Utilities,-2798,-2768804,Debit
2024-02-27,Flipkart Order,Shopping,-1181,-2769985,Debit
2024-04-30,Doctor Visit,Health,-5774,-2775759,Debit
2024-06-11,Freelance Payment,Income,12380,-2763379,Credit
2024-01-29,Zomato Order,Food,-2509,-2765888,Debit
2024-08-28,Amazon Purchase,Shopping,-8333,-2774221,Debit
2025-04-29,Amazon Purchase,Shopping,-9273,-2783494,Debit
2024-11-28,Bonus,Income,22585,-2760909,Credit
2024-12-04,Bank Transfer,Transfer,-4987,-2765896,Debit
2024-10-04,Doctor Visit,Health,-2774,-2768670,Debit
2024-02-26,Water Bill,Utilities,-171,-2768841,Debit
2025-03-07,Bank Transfer,Transfer,-6241,-2775082,Debit
2024-10-19,FD Interest,Savings Interest,24216,-2750866,Credit
2024-01-30,Medical Store,Health,-5882,-2756748,Debit
2024-12-11,FD Interest,Savings Interest,9352,-2747396,Credit
2024-10-05,Received from Rahul,Transfer,-961,-2748357,Debit
2025-01-25,Amazon Purchase,Shopping,-7629,-2755986,Debit
2024-06-21,Internet Recharge,Utilities,-6140,-2762126,Debit
2024-12-26,Electronics,Shopping,-875,-2763001,Debit
2024-10-15,Doctor Visit,Health,-623,-2763624,Debit
2024-03-13,Restaurant Bill,Food,-4438,-2768062,Debit
2025-01-08,Spotify,Entertainment,-1784,-2769846,Debit
2024-12-04,ATM Withdrawal,Cash,-3557,-2773403,Debit
2024-06-06,UPI to Friend,Transfer,-9945,-2783348,Debit
2024-05-24,Refund,Income,27571,-2755777,Credit
2024-01-03,Flipkart Order,Shopping,-9966,-2765743,Debit
2024-10-23,Zomato Order,Food,-5901,-2771644,Debit
2024-12-25,ATM Withdrawal,Cash,-6026,-2777670,Debit
2024-01-17,FD Interest,Savings Interest,26983,-2750687,Credit
2024-06-05,Restaurant Bill,Food,-5784,-2756471,Debit
2024-11-09,ATM Withdrawal,Cash,-3016,-2759487,Debit
2024-05-30,Salary Credit,Income,3646,-2755841,Credit
2025-03-05,Doctor Visit,Health,-6614,-2762455,Debit
2024-03-01,Swiggy,Food,-387,-2762842,Debit
2024-06-22,Spotify,Entertainment,-4007,-2766849,Debit
2024-11-02,Swiggy,Food,-9123,-2775972,Debit
2024-07-27,Restaurant Bill,Food,-5428,-2781400,Debit
2024-10-21,FD Interest,Savings Interest,2797,-2778603,Credit
2025-02-19,FD Interest,Savings Interest,25932,-2752671,Credit
2025-05-04,Medical Store,Health,-1878,-2754549,Debit
2025-02-19,Salary Credit,Income,24776,-2729773,Credit
2024-08-20,Salary Credit,Income,5452,-2724321,Credit
2025-02-19,Interest Credit,Savings Interest,16191,-2708130,Credit
2024-10-09,Uber Ride,Transport,-4560,-2712690,Debit
2024-10-29,Water Bill,Utilities,-8660,-2721350,Debit
2024-11-24,Cash Deposit,Cash,-7207,-2728557,Debit
2024-08-14,Doctor Visit,Health,-4296,-2732853,Debit
2024-11-08,Movie Tickets,Entertainment,-5642,-2738495,Debit
2024-10-30,UPI to Friend,Transfer,-262,-2738757,Debit
2024-06-15,Medical Store,Health,-1905,-2740662,Debit
2024-04-10,YouTube Premium,Entertainment,-9811,-2750473,Debit
2025-03-16,Swiggy,Food,-6421,-2756894,Debit
2025-03-19,Cash Deposit,Cash,-1615,-2758509,Debit
2024-01-31,Electronics,Shopping,-5467,-2763976,Debit
2024-07-26,YouTube Premium,Entertainment,-2671,-2766647,Debit
2024-06-04,YouTube Premium,Entertainment,-9597,-2776244,Debit
2024-03-09,Bonus,Income,8134,-2768110,Credit
2025-02-21,Amazon Purchase,Shopping,-1185,-2769295,Debit
2024-05-28,ATM Withdrawal,Cash,-8651,-2777946,Debit
2024-02-03,Doctor Visit,Health,-8900,-2786846,Debit
2024-08-04,ATM Withdrawal,Cash,-1463,-2788309,Debit
2024-04-11,Cash Deposit,Cash,-8497,-2796806,Debit
2024-12-20,Movie Tickets,Entertainment,-7018,-2803824,Debit
2024-01-01,YouTube Premium,Entertainment,-1867,-2805691,Debit
2024-02-11,Bonus,Income,19858,-2785833,Credit
2024-08-01,Movie Tickets,Entertainment,-3003,-2788836,Debit
2024-05-25,Bank Transfer,Transfer,-246,-2789082,Debit
2024-12-14,Received from Rahul,Transfer,-5779,-2794861,Debit
2024-04-08,UPI to Friend,Transfer,-7428,-2802289,Debit
2024-06-25,Uber Ride,Transport,-9339,-2811628,Debit
2025-02-15,Freelance Payment,Income,14575,-2797053,Credit
2024-08-19,Doctor Visit,Health,-5025,-2802078,Debit
2025-03-06,Water Bill,Utilities,-940,-2803018,Debit
2024-08-08,YouTube Premium,Entertainment,-7115,-2810133,Debit
2025-01-16,Doctor Visit,Health,-6679,-2816812,Debit
2024-07-26,ATM Withdrawal,Cash,-3155,-2819967,Debit
2025-04-09,Refund,Income,8415,-2811552,Credit
2025-01-09,FD Interest,Savings Interest,29330,-2782222,Credit
2025-03-18,Water Bill,Utilities,-1062,-2783284,Debit
2025-03-23,Restaurant Bill,Food,-3539,-2786823,Debit
2024-07-12,Flipkart Order,Shopping,-3399,-2790222,Debit
2024-09-10,Spotify,Entertainment,-238,-2790460,Debit
2024-05-15,Bank Transfer,Transfer,-403,-2790863,Debit
2024-02-16,Spotify,Entertainment,-4165,-2795028,Debit
2024-06-13,Water Bill,Utilities,-4394,-2799422,Debit
2024-12-09,Cash Deposit,Cash,-3837,-2803259,Debit
2025-02-05,FD Interest,Savings Interest,6066,-2797193,Credit
2024-08-06,Spotify,Entertainment,-6742,-2803935,Debit
2024-10-06,Interest Credit,Savings Interest,11892,-2792043,Credit
2025-03-13,Amazon Purchase,Shopping,-7262,-2799305,Debit
2025-05-15,Train Ticket,Transport,-4015,-2803320,Debit
2025-03-27,Bank Transfer,Transfer,-415,-2803735,Debit
2024-06-29,Restaurant Bill,Food,-2627,-2806362,Debit
2024-07-20,Cash Deposit,Cash,-1149,-2807511,Debit
2024-05-02,Swiggy,Food,-6632,-2814143,Debit
2024-08-13,Bonus,Income,18433,-2795710,Credit
2025-04-20,YouTube Premium,Entertainment,-1745,-2797455,Debit
2024-05-11,Interest Credit,Savings Interest,16201,-2781254,Credit
2024-07-16,Uber Ride,Transport,-6713,-2787967,Debit
2024-08-30,Refund,Income,7665,-2780302,Credit
2024-10-07,Electricity Bill,Utilities,-8807,-2789109,Debit
2025-02-22,FD Interest,Savings Interest,21916,-2767193,Credit
2025-02-02,Uber Ride,Transport,-3638,-2770831,Debit
2025-04-15,Movie Tickets,Entertainment,-2828,-2773659,Debit
2024-12-31,Bank Transfer,Transfer,-2970,-2776629,Debit
2025-02-13,Received from Rahul,Transfer,-7325,-2783954,Debit
2024-05-31,ATM Withdrawal,Cash,-5552,-2789506,Debit
2024-10-18,Electronics,Shopping,-3334,-2792840,Debit
2024-12-20,YouTube Premium,Entertainment,-5975,-2798815,Debit
2025-01-17,Water Bill,Utilities,-3682,-2802497,Debit
2024-03-06,Cash Deposit,Cash,-9924,-2812421,Debit
2025-03-09,Petrol,Transport,-5427,-2817848,Debit
2025-01-10,Doctor Visit,Health,-4148,-2821996,Debit
2024-09-17,Medical Store,Health,-5139,-2827135,Debit
2024-10-07,Medical Store,Health,-5971,-2833106,Debit
2024-09-27,Train Ticket,Transport,-1168,-2834274,Debit
2024-07-27,Uber Ride,Transport,-5168,-2839442,Debit
2025-02-25,Bank Transfer,Transfer,-1023,-2840465,Debit
2024-09-30,Myntra Shopping,Shopping,-1722,-2842187,Debit
2024-04-23,ATM Withdrawal,Cash,-1374,-2843561,Debit
2025-02-09,Cash Deposit,Cash,-6870,-2850431,Debit
2024-04-30,Electronics,Shopping,-3611,-2854042,Debit
2024-04-11,YouTube Premium,Entertainment,-1935,-2855977,Debit
2024-05-02,ATM Withdrawal,Cash,-7786,-2863763,Debit
2024-10-17,UPI to Friend,Transfer,-5697,-2869460,Debit
2025-05-02,Medical Store,Health,-6344,-2875804,Debit
2024-07-08,Flipkart Order,Shopping,-6578,-2882382,Debit
2024-08-10,Doctor Visit,Health,-4850,-2887232,Debit
2024-07-24,ATM Withdrawal,Cash,-6895,-2894127,Debit
2024-04-22,Doctor Visit,Health,-3873,-2898000,Debit
2024-11-20,ATM Withdrawal,Cash,-5815,-2903815,Debit
2024-05-14,Cash Deposit,Cash,-4131,-2907946,Debit
2025-03-21,Swiggy,Food,-9844,-2917790,Debit
2025-03-17,Swiggy,Food,-1103,-2918893,Debit
2024-08-30,UPI to Friend,Transfer,-6280,-2925173,Debit
2024-03-27,Electricity Bill,Utilities,-5535,-2930708,Debit
2024-09-24,Interest Credit,Savings Interest,17797,-2912911,Credit
2024-05-16,YouTube Premium,Entertainment,-5490,-2918401,Debit
2024-11-21,Movie Tickets,Entertainment,-2262,-2920663,Debit
2024-02-06,Bonus,Income,17352,-2903311,Credit
2025-04-18,Interest Credit,Savings Interest,15788,-2887523,Credit
2024-06-11,Cash Deposit,Cash,-6050,-2893573,Debit
2024-07-30,ATM Withdrawal,Cash,-598,-2894171,Debit
2024-01-15,Bank Transfer,Transfer,-4675,-2898846,Debit
2025-01-02,Refund,Income,28334,-2870512,Credit
2025-01-07,Cash Deposit,Cash,-5583,-2876095,Debit
2024-08-16,Interest Credit,Savings Interest,10107,-2865988,Credit
2024-11-24,Bonus,Income,14789,-2851199,Credit
2024-11-30,Flipkart Order,Shopping,-5047,-2856246,Debit
2025-04-06,FD Interest,Savings Interest,9257,-2846989,Credit
2025-03-05,Electronics,Shopping,-9006,-2855995,Debit
2024-07-17,ATM Withdrawal,Cash,-9018,-2865013,Debit
2024-03-13,Movie Tickets,Entertainment,-9568,-2874581,Debit
2025-05-13,Cafe Coffee Day,Food,-8844,-2883425,Debit
2024-12-04,Medical Store,Health,-7892,-2891317,Debit
2024-09-26,Zomato Order,Food,-860,-2892177,Debit
2024-02-20,Salary Credit,Income,22236,-2869941,Credit
2024-03-08,Cash Deposit,Cash,-7255,-2877196,Debit
2025-01-18,Medical Store,Health,-4863,-2882059,Debit
2024-05-17,Medical Store,Health,-8248,-2890307,Debit
2025-04-13,Flipkart Order,Shopping,-4145,-2894452,Debit
2024-07-21,UPI to Friend,Transfer,-1895,-2896347,Debit
2024-12-13,Salary Credit,Income,8454,-2887893,Credit
2025-02-12,ATM Withdrawal,Cash,-1694,-2889587,Debit
2024-10-10,Doctor Visit,Health,-7555,-2897142,Debit
2024-06-25,Petrol,Transport,-7304,-2904446,Debit
2024-11-17,Interest Credit,Savings Interest,8961,-2895485,Credit
2024-06-30,ATM Withdrawal,Cash,-276,-2895761,Debit
2024-08-21,Electricity Bill,Utilities,-8468,-2904229,Debit
2024-12-03,Medical Store,Health,-6371,-2910600,Debit
2024-04-16,Bank Transfer,Transfer,-2280,-2912880,Debit
2024-02-22,Internet Recharge,Utilities,-8163,-2921043,Debit
2025-05-03,Restaurant Bill,Food,-1213,-2922256,Debit
2024-09-25,Swiggy,Food,-8074,-2930330,Debit
2024-10-15,Restaurant Bill,Food,-9454,-2939784,Debit
2025-05-13,Salary Credit,Income,8103,-2931681,Credit
2024-12-25,Zomato Order,Food,-2254,-2933935,Debit
2024-02-08,Freelance Payment,Income,28406,-2905529,Credit
2024-07-24,Internet Recharge,Utilities,-5027,-2910556,Debit
2024-01-31,Cafe Coffee Day,Food,-9838,-2920394,Debit
2024-09-04,Movie Tickets,Entertainment,-661,-2921055,Debit
2024-06-04,Interest Credit,Savings Interest,15845,-2905210,Credit
2024-02-04,Flipkart Order,Shopping,-680,-2905890,Debit
2025-02-12,Doctor Visit,Health,-3111,-2909001,Debit
2024-04-29,Cafe Coffee Day,Food,-2427,-2911428,Debit
2024-06-22,Received from Rahul,Transfer,-4416,-2915844,Debit
2024-07-04,Zomato Order,Food,-9846,-2925690,Debit
2025-02-10,YouTube Premium,Entertainment,-7926,-2933616,Debit
2025-02-16,YouTube Premium,Entertainment,-8990,-2942606,Debit
2024-06-21,Myntra Shopping,Shopping,-2937,-2945543,Debit
2024-06-08,FD Interest,Savings Interest,15570,-2929973,Credit
2024-07-13,Spotify,Entertainment,-6364,-2936337,Debit
2024-10-16,Medical Store,Health,-9974,-2946311,Debit
2024-01-04,Cash Deposit,Cash,-1139,-2947450,Debit
2024-11-27,Amazon Purchase,Shopping,-2870,-2950320,Debit
2024-06-17,Internet Recharge,Utilities,-7776,-2958096,Debit
2024-01-07,Salary Credit,Income,7618,-2950478,Credit
2024-09-25,YouTube Premium,Entertainment,-6892,-2957370,Debit
2024-10-21,Cash Deposit,Cash,-4387,-2961757,Debit
2025-01-04,Internet Recharge,Utilities,-2469,-2964226,Debit
2024-10-15,Cafe Coffee Day,Food,-1297,-2965523,Debit
2025-04-22,Bank Transfer,Transfer,-1643,-2967166,Debit
2024-04-10,UPI to Friend,Transfer,-7783,-2974949,Debit
2024-09-30,Internet Recharge,Utilities,-1677,-2976626,Debit
2025-04-06,Cash Deposit,Cash,-2461,-2979087,Debit
2025-03-21,Uber Ride,Transport,-4137,-2983224,Debit
2024-09-17,Medical Store,Health,-3818,-2987042,Debit
2025-01-13,FD Interest,Savings Interest,8017,-2979025,Credit
2024-08-14,Electronics,Shopping,-7749,-2986774,Debit
2024-12-02,Zomato Order,Food,-9855,-2996629,Debit
2024-07-16,Restaurant Bill,Food,-1978,-2998607,Debit
2024-05-09,Refund,Income,25735,-2972872,Credit
2024-11-18,Bank Transfer,Transfer,-3924,-2976796,Debit
2025-02-22,Restaurant Bill,Food,-6918,-2983714,Debit
2025-02-14,Cafe Coffee Day,Food,-4306,-2988020,Debit
2025-04-14,Bonus,Income,12231,-2975789,Credit
2024-10-23,Movie Tickets,Entertainment,-5718,-2981507,Debit
2024-07-16,Movie Tickets,Entertainment,-421,-2981928,Debit
2024-09-30,Movie Tickets,Entertainment,-4684,-2986612,Debit
2024-06-10,Flipkart Order,Shopping,-6158,-2992770,Debit
2025-03-31,Bank Transfer,Transfer,-114,-2992884,Debit
2025-01-28,Salary Credit,Income,27202,-2965682,Credit
2024-06-21,Cafe Coffee Day,Food,-7177,-2972859,Debit
2024-05-16,FD Interest,Savings Interest,7732,-2965127,Credit
2024-06-06,FD Interest,Savings Interest,3486,-2961641,Credit
2024-01-06,Zomato Order,Food,-6259,-2967900,Debit
2024-01-09,Petrol,Transport,-9422,-2977322,Debit
2025-01-21,FD Interest,Savings Interest,3136,-2974186,Credit
2024-12-18,Petrol,Transport,-4710,-2978896,Debit
2025-04-29,Cash Deposit,Cash,-1371,-2980267,Debit
2024-11-16,Petrol,Transport,-4409,-2984676,Debit
2025-03-10,Freelance Payment,Income,18957,-2965719,Credit
2024-11-02,Train Ticket,Transport,-7627,-2973346,Debit
2025-01-16,Uber Ride,Transport,-6462,-2979808,Debit
2024-08-05,Freelance Payment,Income,26552,-2953256,Credit
2024-10-22,ATM Withdrawal,Cash,-9656,-2962912,Debit
2024-11-29,Salary Credit,Income,16371,-2946541,Credit
2024-07-04,Cafe Coffee Day,Food,-2056,-2948597,Debit
2025-04-10,Restaurant Bill,Food,-4292,-2952889,Debit
2024-01-24,Refund,Income,25226,-2927663,Credit
2024-09-12,Train Ticket,Transport,-7175,-2934838,Debit
2025-03-02,Medical Store,Health,-2864,-2937702,Debit
2025-03-21,Doctor Visit,Health,-7078,-2944780,Debit
2024-08-23,Cash Deposit,Cash,-2356,-2947136,Debit
2024-04-06,Train Ticket,Transport,-1039,-2948175,Debit
2025-01-22,Water Bill,Utilities,-1106,-2949281,Debit
2024-09-03,Train Ticket,Transport,-5169,-2954450,Debit
2024-07-27,Interest Credit,Savings Interest,26413,-2928037,Credit
2024-11-17,Interest Credit,Savings Interest,12724,-2915313,Credit
2024-11-07,Interest Credit,Savings Interest,28566,-2886747,Credit
2024-10-27,Internet Recharge,Utilities,-988,-2887735,Debit
2024-12-24,Restaurant Bill,Food,-8957,-2896692,Debit
2024-03-06,Interest Credit,Savings Interest,11335,-2885357,Credit
2025-02-13,Zomato Order,Food,-9102,-2894459,Debit
2024-08-29,Electricity Bill,Utilities,-3415,-2897874,Debit
2024-08-29,Cash Deposit,Cash,-8082,-2905956,Debit
2024-07-29,Interest Credit,Savings Interest,9427,-2896529,Credit
2024-11-12,Train Ticket,Transport,-2713,-2899242,Debit
2024-11-27,Train Ticket,Transport,-2988,-2902230,Debit
2025-03-06,Freelance Payment,Income,9181,-2893049,Credit
2024-04-26,Bank Transfer,Transfer,-452,-2893501,Debit
2024-03-09,Flipkart Order,Shopping,-3328,-2896829,Debit
2025-01-31,Freelance Payment,Income,11145,-2885684,Credit
2025-02-06,FD Interest,Savings Interest,10895,-2874789,Credit
2024-07-05,Cafe Coffee Day,Food,-6519,-2881308,Debit
2024-02-24,Salary Credit,Income,1318,-2879990,Credit
2024-12-18,Spotify,Entertainment,-4057,-2884047,Debit
2025-01-26,Electricity Bill,Utilities,-8915,-2892962,Debit
2024-07-15,ATM Withdrawal,Cash,-6598,-2899560,Debit
2024-03-03,ATM Withdrawal,Cash,-1860,-2901420,Debit
2025-04-14,Cafe Coffee Day,Food,-5589,-2907009,Debit
2024-03-28,FD Interest,Savings Interest,27818,-2879191,Credit
2024-08-25,Uber Ride,Transport,-9328,-2888519,Debit
2025-03-18,Doctor Visit,Health,-7737,-2896256,Debit
2024-07-08,Cash Deposit,Cash,-5482,-2901738,Debit
2024-06-01,Bonus,Income,12810,-2888928,Credit
2024-10-09,Spotify,Entertainment,-8667,-2897595,Debit
2024-03-25,Movie Tickets,Entertainment,-968,-2898563,Debit
2024-06-04,Bank Transfer,Transfer,-5118,-2903681,Debit
2025-03-14,Myntra Shopping,Shopping,-4481,-2908162,Debit
2024-06-30,Movie Tickets,Entertainment,-3980,-2912142,Debit
2024-08-04,Petrol,Transport,-7181,-2919323,Debit
2024-10-21,Restaurant Bill,Food,-7479,-2926802,Debit
2025-01-15,Electronics,Shopping,-5749,-2932551,Debit
2024-02-25,Myntra Shopping,Shopping,-6171,-2938722,Debit
2024-07-01,Myntra Shopping,Shopping,-1267,-2939989,Debit
2024-04-04,Cash Deposit,Cash,-8972,-2948961,Debit
2024-04-30,Movie Tickets,Entertainment,-3301,-2952262,Debit
2024-12-09,Flipkart Order,Shopping,-5519,-2957781,Debit
2025-05-13,Bonus,Income,3797,-2953984,Credit
2024-05-26,Bonus,Income,26882,-2927102,Credit
2025-01-27,Water Bill,Utilities,-8879,-2935981,Debit
2024-03-05,Cash Deposit,Cash,-3158,-2939139,Debit
2024-01-23,Interest Credit,Savings Interest,6138,-2933001,Credit
2024-12-22,Flipkart Order,Shopping,-2221,-2935222,Debit
2025-02-01,Internet Recharge,Utilities,-9193,-2944415,Debit
2024-06-12,Uber Ride,Transport,-9085,-2953500,Debit
2024-09-01,Interest Credit,Savings Interest,9902,-2943598,Credit
2024-02-09,Refund,Income,12719,-2930879,Credit
2024-09-30,Internet Recharge,Utilities,-9663,-2940542,Debit
2024-11-19,Medical Store,Health,-6155,-2946697,Debit
2024-09-06,Doctor Visit,Health,-4390,-2951087,Debit
2024-06-19,ATM Withdrawal,Cash,-9749,-2960836,Debit
2025-03-17,Myntra Shopping,Shopping,-9362,-2970198,Debit
2024-04-01,UPI to Friend,Transfer,-3720,-2973918,Debit
2024-09-30,Uber Ride,Transport,-4514,-2978432,Debit
2025-04-28,Swiggy,Food,-3365,-2981797,Debit
2024-08-21,Movie Tickets,Entertainment,-9423,-2991220,Debit
2024-12-10,Bonus,Income,22952,-2968268,Credit
2025-03-04,Flipkart Order,Shopping,-8321,-2976589,Debit
2024-02-29,ATM Withdrawal,Cash,-3043,-2979632,Debit
2024-07-15,Medical Store,Health,-5230,-2984862,Debit
2024-01-03,Doctor Visit,Health,-108,-2984970,Debit
2024-07-18,Amazon Purchase,Shopping,-1920,-2986890,Debit
2024-02-18,Electricity Bill,Utilities,-3512,-2990402,Debit
2025-01-17,FD Interest,Savings Interest,5463,-2984939,Credit
2024-08-23,Electronics,Shopping,-3337,-2988276,Debit
2024-05-29,Internet Recharge,Utilities,-8562,-2996838,Debit
2025-01-05,Uber Ride,Transport,-5494,-3002332,Debit
2025-03-05,Amazon Purchase,Shopping,-2227,-3004559,Debit
2025-04-17,Amazon Purchase,Shopping,-6620,-3011179,Debit
2024-12-30,Uber Ride,Transport,-5458,-3016637,Debit
2024-04-03,Electricity Bill,Utilities,-808,-3017445,Debit
2024-12-11,Electronics,Shopping,-9430,-3026875,Debit
2024-07-30,FD Interest,Savings Interest,18357,-3008518,Credit
2025-01-01,Flipkart Order,Shopping,-2423,-3010941,Debit
2024-03-21,Refund,Income,17549,-2993392,Credit
2024-04-13,UPI to Friend,Transfer,-2718,-2996110,Debit
2024-12-29,Water Bill,Utilities,-1893,-2998003,Debit
2024-11-23,Electronics,Shopping,-1646,-2999649,Debit
2024-09-24,FD Interest,Savings Interest,27263,-2972386,Credit
2024-10-29,Train Ticket,Transport,-1142,-2973528,Debit
2024-04-20,Train Ticket,Transport,-3760,-2977288,Debit
2024-01-16,YouTube Premium,Entertainment,-3019,-2980307,Debit
2025-03-21,ATM Withdrawal,Cash,-8491,-2988798,Debit
2025-04-23,FD Interest,Savings Interest,14930,-2973868,Credit
2024-02-15,Doctor Visit,Health,-6553,-2980421,Debit
2025-02-18,Bonus,Income,23931,-2956490,Credit
2025-03-04,Interest Credit,Savings Interest,13342,-2943148,Credit
2024-06-26,Medical Store,Health,-5348,-2948496,Debit
2024-02-04,Doctor Visit,Health,-5909,-2954405,Debit
2024-11-15,Zomato Order,Food,-6860,-2961265,Debit
2025-01-30,Movie Tickets,Entertainment,-6028,-2967293,Debit
2024-05-30,Zomato Order,Food,-7005,-2974298,Debit
2024-05-05,Restaurant Bill,Food,-4974,-2979272,Debit
2025-01-11,Bonus,Income,11966,-2967306,Credit
2024-04-15,Electronics,Shopping,-5212,-2972518,Debit
2024-06-17,Movie Tickets,Entertainment,-6561,-2979079,Debit
2024-07-29,Zomato Order,Food,-2025,-2981104,Debit
2024-02-06,Amazon Purchase,Shopping,-8693,-2989797,Debit
2025-01-25,Bank Transfer,Transfer,-9643,-2999440,Debit
2024-04-06,Received from Rahul,Transfer,-9061,-3008501,Debit
2024-03-28,Water Bill,Utilities,-2843,-3011344,Debit
2024-07-08,Electricity Bill,Utilities,-8496,-3019840,Debit
2024-10-12,Interest Credit,Savings Interest,13605,-3006235,Credit
2024-03-26,Swiggy,Food,-1893,-3008128,Debit
2024-10-25,UPI to Friend,Transfer,-7266,-3015394,Debit
2024-11-25,Cash Deposit,Cash,-7270,-3022664,Debit
2025-01-10,Received from Rahul,Transfer,-9330,-3031994,Debit
2025-05-11,ATM Withdrawal,Cash,-9154,-3041148,Debit
2024-11-04,Amazon Purchase,Shopping,-6655,-3047803,Debit
2024-11-14,Internet Recharge,Utilities,-1260,-3049063,Debit
2025-03-26,Petrol,Transport,-5291,-3054354,Debit
2024-02-26,Cash Deposit,Cash,-3604,-3057958,Debit
2024-01-25,Swiggy,Food,-1714,-3059672,Debit
2024-04-23,Cash Deposit,Cash,-8913,-3068585,Debit
2024-12-29,Medical Store,Health,-2317,-3070902,Debit
2024-06-27,Electronics,Shopping,-4711,-3075613,Debit
2024-10-31,Swiggy,Food,-6290,-3081903,Debit
2025-03-03,Bonus,Income,6722,-3075181,Credit
2024-12-16,YouTube Premium,Entertainment,-4766,-3079947,Debit
2024-08-22,ATM Withdrawal,Cash,-8084,-3088031,Debit
2024-03-10,Water Bill,Utilities,-6511,-3094542,Debit
2024-07-06,Cash Deposit,Cash,-8464,-3103006,Debit
2024-11-19,Train Ticket,Transport,-4116,-3107122,Debit
2024-01-14,Internet Recharge,Utilities,-1952,-3109074,Debit
2024-05-27,Cafe Coffee Day,Food,-4086,-3113160,Debit
2024-02-18,FD Interest,Savings Interest,20010,-3093150,Credit
2025-01-30,Uber Ride,Transport,-709,-3093859,Debit
2025-04-20,Petrol,Transport,-2226,-3096085,Debit
2024-09-19,Salary Credit,Income,20434,-3075651,Credit
2024-02-20,Uber Ride,Transport,-8196,-3083847,Debit
2024-08-28,Interest Credit,Savings Interest,14358,-3069489,Credit
2024-10-30,Electronics,Shopping,-919,-3070408,Debit
2024-12-09,Electronics,Shopping,-1968,-3072376,Debit
2024-08-15,Swiggy,Food,-3555,-3075931,Debit
2025-04-26,Received from Rahul,Transfer,-2958,-3078889,Debit
2024-05-29,UPI to Friend,Transfer,-453,-3079342,Debit
2024-06-29,Cash Deposit,Cash,-6455,-3085797,Debit
2025-03-04,Water Bill,Utilities,-4009,-3089806,Debit
2024-10-21,Flipkart Order,Shopping,-3581,-3093387,Debit
2024-12-04,ATM Withdrawal,Cash,-3305,-3096692,Debit
2024-06-05,Water Bill,Utilities,-1434,-3098126,Debit
2024-04-14,FD Interest,Savings Interest,6625,-3091501,Credit
2024-08-31,Doctor Visit,Health,-9151,-3100652,Debit
2024-02-05,Received from Rahul,Transfer,-1827,-3102479,Debit
2025-01-06,YouTube Premium,Entertainment,-2743,-3105222,Debit
2024-01-01,Doctor Visit,Health,-3971,-3109193,Debit
2024-12-19,Cafe Coffee Day,Food,-8280,-3117473,Debit
2024-09-19,FD Interest,Savings Interest,28821,-3088652,Credit
2024-11-09,Doctor Visit,Health,-9885,-3098537,Debit
2025-03-14,Electricity Bill,Utilities,-6952,-3105489,Debit
2024-10-10,Uber Ride,Transport,-1590,-3107079,Debit
2024-08-31,Uber Ride,Transport,-3569,-3110648,Debit
2025-05-06,Electricity Bill,Utilities,-2255,-3112903,Debit
2024-05-24,Internet Recharge,Utilities,-2730,-3115633,Debit
2025-01-30,Bank Transfer,Transfer,-4919,-3120552,Debit
2024-06-10,Electronics,Shopping,-8015,-3128567,Debit
2024-11-20,ATM Withdrawal,Cash,-5633,-3134200,Debit
2024-02-06,Electricity Bill,Utilities,-7870,-3142070,Debit
2025-03-07,Uber Ride,Transport,-4406,-3146476,Debit
2024-03-05,Amazon Purchase,Shopping,-5344,-3151820,Debit
2025-02-05,Interest Credit,Savings Interest,21523,-3130297,Credit
2025-04-10,Electronics,Shopping,-4178,-3134475,Debit
2025-01-25,FD Interest,Savings Interest,14663,-3119812,Credit
2025-05-06,FD Interest,Savings Interest,19666,-3100146,Credit
2025-04-28,Freelance Payment,Income,2321,-3097825,Credit
2024-02-12,Medical Store,Health,-2110,-3099935,Debit
2024-04-03,Myntra Shopping,Shopping,-9732,-3109667,Debit
2025-01-21,Interest Credit,Savings Interest,28789,-3080878,Credit
2025-04-11,Movie Tickets,Entertainment,-4339,-3085217,Debit
2024-03-05,Internet Recharge,Utilities,-7823,-3093040,Debit
2025-01-28,Swiggy,Food,-1474,-3094514,Debit
2025-01-28,Cash Deposit,Cash,-3980,-3098494,Debit
2025-03-25,Cash Deposit,Cash,-301,-3098795,Debit
2024-04-03,UPI to Friend,Transfer,-7676,-3106471,Debit
2024-11-14,Swiggy,Food,-3160,-3109631,Debit
2025-01-07,Interest Credit,Savings Interest,4883,-3104748,Credit
2024-04-22,Refund,Income,25106,-3079642,Credit
2024-09-07,YouTube Premium,Entertainment,-1711,-3081353,Debit
2024-03-07,Received from Rahul,Transfer,-5577,-3086930,Debit
2024-02-16,Movie Tickets,Entertainment,-943,-3087873,Debit
2024-10-30,Train Ticket,Transport,-4098,-3091971,Debit
2024-02-20,Interest Credit,Savings Interest,13223,-3078748,Credit
2025-05-04,Medical Store,Health,-1244,-3079992,Debit
2025-02-09,Salary Credit,Income,3311,-3076681,Credit
2025-03-02,Freelance Payment,Income,23183,-3053498,Credit
2024-02-12,Interest Credit,Savings Interest,27320,-3026178,Credit
2024-12-22,Freelance Payment,Income,19803,-3006375,Credit
2025-01-10,Movie Tickets,Entertainment,-4347,-3010722,Debit
2024-04-23,Spotify,Entertainment,-1532,-3012254,Debit
2025-01-15,Cash Deposit,Cash,-7210,-3019464,Debit
2024-05-30,Spotify,Entertainment,-3206,-3022670,Debit
2025-04-13,Myntra Shopping,Shopping,-3605,-3026275,Debit
2025-02-02,FD Interest,Savings Interest,14043,-3012232,Credit
2024-01-27,Water Bill,Utilities,-2233,-3014465,Debit
2024-02-15,Doctor Visit,Health,-248,-3014713,Debit
2024-07-20,YouTube Premium,Entertainment,-7642,-3022355,Debit
2025-01-26,Cash Deposit,Cash,-9710,-3032065,Debit
2024-03-23,FD Interest,Savings Interest,19761,-3012304,Credit
2025-01-07,Doctor Visit,Health,-4742,-3017046,Debit
2024-01-14,Refund,Income,5017,-3012029,Credit
2025-05-13,Spotify,Entertainment,-221,-3012250,Debit
2024-11-12,Movie Tickets,Entertainment,-3466,-3015716,Debit
2025-05-08,Doctor Visit,Health,-1001,-3016717,Debit
2024-09-21,Train Ticket,Transport,-9750,-3026467,Debit
2025-01-25,Water Bill,Utilities,-8832,-3035299,Debit
2024-02-02,Electricity Bill,Utilities,-422,-3035721,Debit
2024-08-11,YouTube Premium,Entertainment,-502,-3036223,Debit
2024-02-08,Internet Recharge,Utilities,-9553,-3045776,Debit
2025-02-21,Restaurant Bill,Food,-635,-3046411,Debit
2025-01-11,Restaurant Bill,Food,-4303,-3050714,Debit
2024-10-18,Doctor Visit,Health,-6967,-3057681,Debit
2025-01-24,Electricity Bill,Utilities,-5608,-3063289,Debit
2024-10-14,Train Ticket,Transport,-2314,-3065603,Debit
2024-07-17,Interest Credit,Savings Interest,29268,-3036335,Credit
2024-10-23,Spotify,Entertainment,-287,-3036622,Debit
2024-07-30,Spotify,Entertainment,-4656,-3041278,Debit
2024-09-11,ATM Withdrawal,Cash,-2638,-3043916,Debit
2024-05-20,Medical Store,Health,-1514,-3045430,Debit
2024-08-04,YouTube Premium,Entertainment,-6327,-3051757,Debit
2024-03-28,Salary Credit,Income,9407,-3042350,Credit
2024-01-08,YouTube Premium,Entertainment,-1152,-3043502,Debit
2024-05-03,Received from Rahul,Transfer,-8135,-3051637,Debit
2024-05-05,Flipkart Order,Shopping,-9914,-3061551,Debit
2025-04-29,Water Bill,Utilities,-6634,-3068185,Debit
2024-04-20,Salary Credit,Income,7384,-3060801,Credit
2024-09-07,Received from Rahul,Transfer,-3365,-3064166,Debit
2025-01-03,Bank Transfer,Transfer,-8242,-3072408,Debit
2024-05-30,Interest Credit,Savings Interest,13905,-3058503,Credit
2024-05-23,YouTube Premium,Entertainment,-2448,-3060951,Debit
2024-03-02,Water Bill,Utilities,-3163,-3064114,Debit
2024-06-10,ATM Withdrawal,Cash,-7877,-3071991,Debit
2024-05-05,Petrol,Transport,-9917,-3081908,Debit
2025-05-01,Train Ticket,Transport,-9470,-3091378,Debit
2024-07-16,Freelance Payment,Income,15640,-3075738,Credit
2024-06-08,Flipkart Order,Shopping,-6327,-3082065,Debit
2024-02-21,Spotify,Entertainment,-7260,-3089325,Debit
2024-02-07,Water Bill,Utilities,-2998,-3092323,Debit
2024-08-13,Interest Credit,Savings Interest,24451,-3067872,Credit
2025-01-17,Movie Tickets,Entertainment,-7555,-3075427,Debit
2024-07-13,Cafe Coffee Day,Food,-2117,-3077544,Debit
2025-04-07,UPI to Friend,Transfer,-1123,-3078667,Debit
2024-02-06,FD Interest,Savings Interest,11616,-3067051,Credit
2024-01-09,Uber Ride,Transport,-6831,-3073882,Debit
2024-03-09,ATM Withdrawal,Cash,-9831,-3083713,Debit
2024-04-13,Cash Deposit,Cash,-6079,-3089792,Debit
2024-05-03,Petrol,Transport,-7644,-3097436,Debit
2025-04-25,Restaurant Bill,Food,-4004,-3101440,Debit
2024-05-26,Swiggy,Food,-3000,-3104440,Debit
2024-06-14,Bonus,Income,17341,-3087099,Credit
2024-01-06,Freelance Payment,Income,7392,-3079707,Credit
2024-09-21,Zomato Order,Food,-2378,-3082085,Debit
2024-08-26,Train Ticket,Transport,-4845,-3086930,Debit
2025-02-06,Salary Credit,Income,27197,-3059733,Credit
2025-05-13,Medical Store,Health,-5394,-3065127,Debit
2024-12-04,Doctor Visit,Health,-6061,-3071188,Debit
2024-09-09,Medical Store,Health,-1403,-3072591,Debit
2025-02-03,Bonus,Income,4854,-3067737,Credit
2024-05-20,Petrol,Transport,-3920,-3071657,Debit
2025-02-07,Petrol,Transport,-9581,-3081238,Debit
2024-06-10,FD Interest,Savings Interest,3854,-3077384,Credit
2024-05-17,Train Ticket,Transport,-8986,-3086370,Debit
2024-09-28,Doctor Visit,Health,-9778,-3096148,Debit
2025-01-29,Spotify,Entertainment,-9908,-3106056,Debit
2024-03-14,FD Interest,Savings Interest,580,-3105476,Credit
2024-10-07,YouTube Premium,Entertainment,-3309,-3108785,Debit
2025-03-03,Freelance Payment,Income,17619,-3091166,Credit
2024-05-01,FD Interest,Savings Interest,4089,-3087077,Credit
2025-03-18,Interest Credit,Savings Interest,19190,-3067887,Credit
2024-05-28,Doctor Visit,Health,-3354,-3071241,Debit
2025-03-28,Freelance Payment,Income,2475,-3068766,Credit
2025-05-13,Doctor Visit,Health,-3065,-3071831,Debit
2024-12-01,Electronics,Shopping,-6851,-3078682,Debit
2024-02-16,Zomato Order,Food,-8805,-3087487,Debit
2024-04-11,Bonus,Income,23909,-3063578,Credit
2025-03-25,Cash Deposit,Cash,-5512,-3069090,Debit
2024-03-16,Cash Deposit,Cash,-9192,-3078282,Debit
2024-06-10,ATM Withdrawal,Cash,-6226,-3084508,Debit
2024-08-04,Cash Deposit,Cash,-4786,-3089294,Debit
2025-01-27,FD Interest,Savings Interest,554,-3088740,Credit
2024-11-17,YouTube Premium,Entertainment,-3143,-3091883,Debit
2024-12-11,YouTube Premium,Entertainment,-2337,-3094220,Debit
2024-03-24,Interest Credit,Savings Interest,21739,-3072481,Credit
2024-11-20,Interest Credit,Savings Interest,5484,-3066997,Credit
2025-03-22,Movie Tickets,Entertainment,-5156,-3072153,Debit
2025-03-28,Spotify,Entertainment,-4680,-3076833,Debit
2024-12-16,Restaurant Bill,Food,-5816,-3082649,Debit
2024-11-06,Interest Credit,Savings Interest,14758,-3067891,Credit
2024-06-24,Petrol,Transport,-9517,-3077408,Debit
2024-07-13,Electricity Bill,Utilities,-6583,-3083991,Debit
2024-01-28,Cash Deposit,Cash,-2008,-3085999,Debit
2024-06-05,Bonus,Income,1822,-3084177,Credit
2024-06-23,Internet Recharge,Utilities,-3621,-3087798,Debit
2024-07-02,Doctor Visit,Health,-448,-3088246,Debit
2024-01-17,ATM Withdrawal,Cash,-1159,-3089405,Debit
2024-12-11,Cash Deposit,Cash,-9531,-3098936,Debit
2024-03-16,Medical Store,Health,-7172,-3106108,Debit
2024-08-11,Salary Credit,Income,10078,-3096030,Credit
2024-06-16,Bank Transfer,Transfer,-631,-3096661,Debit
2024-11-21,ATM Withdrawal,Cash,-9340,-3106001,Debit
2025-01-22,FD Interest,Savings Interest,7641,-3098360,Credit
2025-04-25,FD Interest,Savings Interest,11820,-3086540,Credit
2024-04-14,Electricity Bill,Utilities,-4348,-3090888,Debit
2025-02-03,FD Interest,Savings Interest,6026,-3084862,Credit
2024-07-17,Internet Recharge,Utilities,-7706,-3092568,Debit
2024-09-18,Train Ticket,Transport,-5478,-3098046,Debit
2025-02-16,Uber Ride,Transport,-7059,-3105105,Debit
2024-02-25,Refund,Income,17639,-3087466,Credit
2024-02-10,Movie Tickets,Entertainment,-3434,-3090900,Debit
2024-11-25,Uber Ride,Transport,-9783,-3100683,Debit
2024-04-18,UPI to Friend,Transfer,-4937,-3105620,Debit
2024-04-27,Restaurant Bill,Food,-9485,-3115105,Debit
2024-06-03,Water Bill,Utilities,-8275,-3123380,Debit
2025-02-26,Movie Tickets,Entertainment,-6485,-3129865,Debit
2024-04-12,Medical Store,Health,-4040,-3133905,Debit
2024-10-14,Electronics,Shopping,-6815,-3140720,Debit
2025-04-13,Cafe Coffee Day,Food,-5720,-3146440,Debit
2024-01-28,Doctor Visit,Health,-7517,-3153957,Debit
2024-04-20,Restaurant Bill,Food,-4631,-3158588,Debit
2024-04-07,ATM Withdrawal,Cash,-824,-3159412,Debit
2024-10-10,Received from Rahul,Transfer,-9750,-3169162,Debit
2025-01-30,Medical Store,Health,-5492,-3174654,Debit
2024-03-23,Myntra Shopping,Shopping,-6525,-3181179,Debit
2024-01-27,Uber Ride,Transport,-313,-3181492,Debit
2024-01-30,Movie Tickets,Entertainment,-3781,-3185273,Debit
2025-03-01,Received from Rahul,Transfer,-5821,-3191094,Debit
2024-07-13,Myntra Shopping,Shopping,-8885,-3199979,Debit
2025-02-02,YouTube Premium,Entertainment,-6431,-3206410,Debit
2025-05-11,Train Ticket,Transport,-1325,-3207735,Debit
2024-02-01,Train Ticket,Transport,-4531,-3212266,Debit
2024-06-17,Salary Credit,Income,15461,-3196805,Credit
2024-05-05,Interest Credit,Savings Interest,15367,-3181438,Credit
2024-02-14,Received from Rahul,Transfer,-4100,-3185538,Debit
2025-04-18,Train Ticket,Transport,-9238,-3194776,Debit
2024-10-28,Received from Rahul,Transfer,-9956,-3204732,Debit
2025-03-05,UPI to Friend,Transfer,-5506,-3210238,Debit
2024-08-12,Myntra Shopping,Shopping,-487,-3210725,Debit
2025-05-11,Train Ticket,Transport,-4695,-3215420,Debit
2024-06-01,ATM Withdrawal,Cash,-3384,-3218804,Debit
2024-07-31,Freelance Payment,Income,29298,-3189506,Credit
2024-06-23,Electronics,Shopping,-3251,-3192757,Debit
2024-01-13,ATM Withdrawal,Cash,-3330,-3196087,Debit
2024-10-29,Cash Deposit,Cash,-258,-3196345,Debit
2024-08-16,Flipkart Order,Shopping,-6538,-3202883,Debit
2024-02-27,Myntra Shopping,Shopping,-1817,-3204700,Debit
2025-01-26,UPI to Friend,Transfer,-7900,-3212600,Debit
2024-01-18,Cafe Coffee Day,Food,-6679,-3219279,Debit
2025-03-07,FD Interest,Savings Interest,11905,-3207374,Credit
2025-05-10,Doctor Visit,Health,-8274,-3215648,Debit
2024-06-22,Electricity Bill,Utilities,-888,-3216536,Debit
2024-01-25,Restaurant Bill,Food,-111,-3216647,Debit
2025-02-06,Swiggy,Food,-4025,-3220672,Debit
2024-04-18,FD Interest,Savings Interest,13501,-3207171,Credit
2025-01-11,Train Ticket,Transport,-1000,-3208171,Debit
2025-02-26,Electronics,Shopping,-4278,-3212449,Debit
2024-02-08,Movie Tickets,Entertainment,-7571,-3220020,Debit
2024-08-22,Movie Tickets,Entertainment,-4246,-3224266,Debit
2025-04-04,Uber Ride,Transport,-4190,-3228456,Debit
2024-11-25,Train Ticket,Transport,-4401,-3232857,Debit
2024-02-21,Internet Recharge,Utilities,-7863,-3240720,Debit
2024-02-14,Bank Transfer,Transfer,-6213,-3246933,Debit
2024-06-22,ATM Withdrawal,Cash,-1957,-3248890,Debit
2024-09-09,Doctor Visit,Health,-3052,-3251942,Debit
2025-01-06,Zomato Order,Food,-1389,-3253331,Debit
2024-08-11,Zomato Order,Food,-1737,-3255068,Debit
2024-09-28,Amazon Purchase,Shopping,-1277,-3256345,Debit
2024-04-23,Restaurant Bill,Food,-9690,-3266035,Debit
2024-09-14,Salary Credit,Income,5524,-3260511,Credit
2024-04-09,Medical Store,Health,-9079,-3269590,Debit
2024-12-14,Train Ticket,Transport,-931,-3270521,Debit
2024-04-19,Train Ticket,Transport,-3593,-3274114,Debit
2025-01-01,Spotify,Entertainment,-9958,-3284072,Debit
2024-05-24,Freelance Payment,Income,21269,-3262803,Credit
2024-11-21,Water Bill,Utilities,-9428,-3272231,Debit
2024-03-06,UPI to Friend,Transfer,-7418,-3279649,Debit
2024-11-10,Electricity Bill,Utilities,-946,-3280595,Debit
2024-07-12,Internet Recharge,Utilities,-1994,-3282589,Debit
2024-02-25,Interest Credit,Savings Interest,28381,-3254208,Credit
2024-06-06,Train Ticket,Transport,-5641,-3259849,Debit
2024-06-04,Zomato Order,Food,-8908,-3268757,Debit
2024-10-16,Spotify,Entertainment,-5395,-3274152,Debit
2024-11-06,Bonus,Income,28457,-3245695,Credit
2024-03-08,Medical Store,Health,-2427,-3248122,Debit
2024-11-30,Electronics,Shopping,-4956,-3253078,Debit
2024-12-19,ATM Withdrawal,Cash,-4521,-3257599,Debit
2024-02-21,FD Interest,Savings Interest,29148,-3228451,Credit
2024-01-09,Bonus,Income,10769,-3217682,Credit
2025-01-17,Doctor Visit,Health,-3447,-3221129,Debit
2024-10-28,Medical Store,Health,-3867,-3224996,Debit
2024-11-06,Myntra Shopping,Shopping,-4711,-3229707,Debit
2024-02-10,Water Bill,Utilities,-7009,-3236716,Debit
2024-01-11,Salary Credit,Income,15849,-3220867,Credit
2024-04-14,Swiggy,Food,-7878,-3228745,Debit
2024-12-05,FD Interest,Savings Interest,11775,-3216970,Credit
2024-12-22,Restaurant Bill,Food,-9815,-3226785,Debit
2024-04-18,Electricity Bill,Utilities,-4330,-3231115,Debit
2025-02-21,FD Interest,Savings Interest,22935,-3208180,Credit
2025-04-16,Electronics,Shopping,-8319,-3216499,Debit
2024-09-04,Uber Ride,Transport,-2804,-3219303,Debit
2025-01-25,Freelance Payment,Income,5097,-3214206,Credit
2024-07-20,Uber Ride,Transport,-4494,-3218700,Debit
2024-03-21,Bank Transfer,Transfer,-504,-3219204,Debit
2025-02-18,Interest Credit,Savings Interest,24744,-3194460,Credit
2024-02-12,Received from Rahul,Transfer,-8703,-3203163,Debit
2025-03-20,Medical Store,Health,-2651,-3205814,Debit
2024-10-30,Medical Store,Health,-3347,-3209161,Debit
2024-06-10,Bonus,Income,5659,-3203502,Credit
2024-05-03,UPI to Friend,Transfer,-6164,-3209666,Debit
2024-05-07,Internet Recharge,Utilities,-4833,-3214499,Debit
2024-11-11,Swiggy,Food,-4836,-3219335,Debit
2024-11-03,UPI to Friend,Transfer,-1222,-3220557,Debit
2024-11-11,UPI to Friend,Transfer,-7041,-3227598,Debit
2024-03-12,UPI to Friend,Transfer,-2707,-3230305,Debit
2024-11-06,Water Bill,Utilities,-8505,-3238810,Debit
2024-01-10,Water Bill,Utilities,-8863,-3247673,Debit
2024-02-23,Bank Transfer,Transfer,-8124,-3255797,Debit
2024-08-14,UPI to Friend,Transfer,-2320,-3258117,Debit
2025-03-30,FD Interest,Savings Interest,8752,-3249365,Credit
2025-03-06,Swiggy,Food,-6350,-3255715,Debit
2024-04-20,Restaurant Bill,Food,-8727,-3264442,Debit
2024-07-16,Cash Deposit,Cash,-5218,-3269660,Debit
2024-01-11,Spotify,Entertainment,-4846,-3274506,Debit
2025-03-25,FD Interest,Savings Interest,9527,-3264979,Credit
2024-11-02,Amazon Purchase,Shopping,-3196,-3268175,Debit
2024-05-13,Spotify,Entertainment,-9067,-3277242,Debit
2025-01-25,Salary Credit,Income,8191,-3269051,Credit
2024-03-12,FD Interest,Savings Interest,17609,-3251442,Credit
2025-04-05,FD Interest,Savings Interest,22776,-3228666,Credit
2024-09-09,Salary Credit,Income,27187,-3201479,Credit
2025-04-18,ATM Withdrawal,Cash,-6410,-3207889,Debit
2025-04-02,Bonus,Income,29805,-3178084,Credit
2025-03-14,ATM Withdrawal,Cash,-7749,-3185833,Debit
2025-02-09,FD Interest,Savings Interest,23003,-3162830,Credit
2025-02-22,Zomato Order,Food,-1736,-3164566,Debit
2025-04-09,Myntra Shopping,Shopping,-7372,-3171938,Debit
2024-12-01,Interest Credit,Savings Interest,21289,-3150649,Credit
2025-03-05,Spotify,Entertainment,-9447,-3160096,Debit
2024-02-18,Received from Rahul,Transfer,-9238,-3169334,Debit
2024-12-01,Salary Credit,Income,12096,-3157238,Credit
2024-02-19,Cash Deposit,Cash,-6678,-3163916,Debit
2024-04-26,FD Interest,Savings Interest,25045,-3138871,Credit
2024-08-18,UPI to Friend,Transfer,-8514,-3147385,Debit
2024-12-24,Myntra Shopping,Shopping,-5422,-3152807,Debit
2024-06-01,Salary Credit,Income,21373,-3131434,Credit
2024-01-06,Petrol,Transport,-999,-3132433,Debit
2025-03-06,Train Ticket,Transport,-5238,-3137671,Debit
2024-10-05,Interest Credit,Savings Interest,6733,-3130938,Credit
2025-05-08,Medical Store,Health,-7200,-3138138,Debit
2024-06-13,Electronics,Shopping,-7389,-3145527,Debit
2025-01-02,Restaurant Bill,Food,-2808,-3148335,Debit
2024-05-11,YouTube Premium,Entertainment,-6399,-3154734,Debit
2024-04-03,Medical Store,Health,-2132,-3156866,Debit
2025-04-26,Petrol,Transport,-532,-3157398,Debit
2024-11-30,Uber Ride,Transport,-9772,-3167170,Debit
2024-04-20,Train Ticket,Transport,-380,-3167550,Debit
2025-02-26,ATM Withdrawal,Cash,-621,-3168171,Debit
2024-09-18,Swiggy,Food,-721,-3168892,Debit
2025-03-18,Zomato Order,Food,-9303,-3178195,Debit
2025-01-14,Uber Ride,Transport,-7360,-3185555,Debit
2024-12-03,Internet Recharge,Utilities,-4592,-3190147,Debit
2024-05-10,Amazon Purchase,Shopping,-3887,-3194034,Debit
2024-11-06,Bank Transfer,Transfer,-8313,-3202347,Debit
2025-03-22,Restaurant Bill,Food,-3309,-3205656,Debit
2025-03-06,Flipkart Order,Shopping,-1811,-3207467,Debit
2025-03-11,YouTube Premium,Entertainment,-9212,-3216679,Debit
2024-10-01,Bank Transfer,Transfer,-8544,-3225223,Debit
2024-04-12,ATM Withdrawal,Cash,-6194,-3231417,Debit
2024-10-31,YouTube Premium,Entertainment,-9082,-3240499,Debit
2024-02-22,Salary Credit,Income,25188,-3215311,Credit
2024-02-23,Train Ticket,Transport,-3051,-3218362,Debit
2024-03-10,Amazon Purchase,Shopping,-108,-3218470,Debit
2024-07-28,Interest Credit,Savings Interest,16376,-3202094,Credit
2024-12-23,Salary Credit,Income,6482,-3195612,Credit
2024-07-14,Flipkart Order,Shopping,-5167,-3200779,Debit
2024-01-23,Electronics,Shopping,-5277,-3206056,Debit
2024-08-09,FD Interest,Savings Interest,16219,-3189837,Credit
2024-08-05,Restaurant Bill,Food,-9572,-3199409,Debit
2025-03-27,Spotify,Entertainment,-9810,-3209219,Debit
2024-03-12,Bank Transfer,Transfer,-4515,-3213734,Debit
2024-01-03,Restaurant Bill,Food,-8631,-3222365,Debit
2024-03-15,Amazon Purchase,Shopping,-3340,-3225705,Debit
2025-02-05,Flipkart Order,Shopping,-1756,-3227461,Debit
2024-12-02,Myntra Shopping,Shopping,-3508,-3230969,Debit
2024-01-11,Water Bill,Utilities,-8026,-3238995,Debit
2024-03-14,Interest Credit,Savings Interest,815,-3238180,Credit
2024-09-03,Interest Credit,Savings Interest,29580,-3208600,Credit
2024-11-21,Medical Store,Health,-4888,-3213488,Debit
2024-08-31,Internet Recharge,Utilities,-2957,-3216445,Debit
2025-02-05,Internet Recharge,Utilities,-2489,-3218934,Debit
2024-09-04,Train Ticket,Transport,-9438,-3228372,Debit
2025-01-30,Train Ticket,Transport,-6289,-3234661,Debit
2024-06-26,Electricity Bill,Utilities,-8942,-3243603,Debit
2025-05-08,Electricity Bill,Utilities,-1619,-3245222,Debit
2024-11-28,YouTube Premium,Entertainment,-9787,-3255009,Debit
2024-07-30,YouTube Premium,Entertainment,-455,-3255464,Debit
2024-02-19,Medical Store,Health,-7178,-3262642,Debit
2024-07-07,YouTube Premium,Entertainment,-4002,-3266644,Debit
2024-01-24,Myntra Shopping,Shopping,-4950,-3271594,Debit
2024-09-14,Spotify,Entertainment,-8705,-3280299,Debit
2024-03-20,Train Ticket,Transport,-6277,-3286576,Debit
2024-01-31,Myntra Shopping,Shopping,-1930,-3288506,Debit
2025-01-03,Zomato Order,Food,-6205,-3294711,Debit
2024-10-05,Petrol,Transport,-9079,-3303790,Debit
2024-01-10,Interest Credit,Savings Interest,9299,-3294491,Credit
2025-04-22,Water Bill,Utilities,-4564,-3299055,Debit
2024-08-27,ATM Withdrawal,Cash,-9809,-3308864,Debit
2025-04-10,Received from Rahul,Transfer,-3500,-3312364,Debit
2025-01-15,Cash Deposit,Cash,-2422,-3314786,Debit
2024-08-31,YouTube Premium,Entertainment,-4952,-3319738,Debit
2024-07-25,Received from Rahul,Transfer,-1961,-3321699,Debit
2024-12-25,Flipkart Order,Shopping,-6723,-3328422,Debit
2024-11-17,UPI to Friend,Transfer,-7598,-3336020,Debit
2024-12-16,FD Interest,Savings Interest,26809,-3309211,Credit
2024-10-04,FD Interest,Savings Interest,3300,-3305911,Credit
2024-03-02,Interest Credit,Savings Interest,23256,-3282655,Credit
2025-02-01,Flipkart Order,Shopping,-1225,-3283880,Debit
2024-02-24,Salary Credit,Income,14006,-3269874,Credit
2024-04-22,Doctor Visit,Health,-7472,-3277346,Debit
2024-03-19,Train Ticket,Transport,-1217,-3278563,Debit
2024-11-23,YouTube Premium,Entertainment,-1122,-3279685,Debit
2025-04-22,Medical Store,Health,-2010,-3281695,Debit
2024-12-18,Medical Store,Health,-3737,-3285432,Debit
2024-02-19,Internet Recharge,Utilities,-5308,-3290740,Debit
2024-08-16,Uber Ride,Transport,-6219,-3296959,Debit
2024-02-11,UPI to Friend,Transfer,-4334,-3301293,Debit
2025-01-14,Internet Recharge,Utilities,-9322,-3310615,Debit
2024-10-04,Bank Transfer,Transfer,-4583,-3315198,Debit
2024-07-03,Freelance Payment,Income,4313,-3310885,Credit
2025-04-14,Movie Tickets,Entertainment,-2510,-3313395,Debit
2024-04-29,Bank Transfer,Transfer,-3380,-3316775,Debit
2024-11-21,YouTube Premium,Entertainment,-1940,-3318715,Debit
2024-10-01,Uber Ride,Transport,-3208,-3321923,Debit
2024-12-22,Train Ticket,Transport,-2496,-3324419,Debit
2025-01-21,Doctor Visit,Health,-7922,-3332341,Debit
2024-11-06,Train Ticket,Transport,-4628,-3336969,Debit
2024-04-18,Freelance Payment,Income,12574,-3324395,Credit
2024-03-27,Myntra Shopping,Shopping,-4546,-3328941,Debit
2024-09-14,Restaurant Bill,Food,-9295,-3338236,Debit
2024-08-01,Medical Store,Health,-9043,-3347279,Debit
2024-07-04,Electronics,Shopping,-9173,-3356452,Debit
2024-05-02,Doctor Visit,Health,-3421,-3359873,Debit
2024-01-27,Petrol,Transport,-2190,-3362063,Debit
2024-11-21,Train Ticket,Transport,-1275,-3363338,Debit
2024-01-09,Train Ticket,Transport,-445,-3363783,Debit
2024-08-14,Movie Tickets,Entertainment,-5909,-3369692,Debit
2025-03-20,Cash Deposit,Cash,-6991,-3376683,Debit
2024-02-07,Interest Credit,Savings Interest,19032,-3357651,Credit
2024-07-30,FD Interest,Savings Interest,25815,-3331836,Credit
2024-12-09,Medical Store,Health,-6390,-3338226,Debit
2025-03-11,FD Interest,Savings Interest,23080,-3315146,Credit
2024-03-25,Movie Tickets,Entertainment,-5866,-3321012,Debit
2025-02-22,Refund,Income,12506,-3308506,Credit
2024-02-27,Swiggy,Food,-564,-3309070,Debit
2024-09-29,Medical Store,Health,-5054,-3314124,Debit
2024-12-25,Myntra Shopping,Shopping,-8886,-3323010,Debit
2025-01-05,Petrol,Transport,-2831,-3325841,Debit
2024-03-07,Doctor Visit,Health,-8648,-3334489,Debit
2024-07-17,Uber Ride,Transport,-9944,-3344433,Debit
2024-05-21,Cafe Coffee Day,Food,-8769,-3353202,Debit
2024-09-17,Movie Tickets,Entertainment,-7888,-3361090,Debit
2025-05-12,Doctor Visit,Health,-1875,-3362965,Debit
2025-01-27,Internet Recharge,Utilities,-9626,-3372591,Debit
2024-12-26,Bonus,Income,19463,-3353128,Credit
2024-06-27,FD Interest,Savings Interest,9761,-3343367,Credit
2025-02-24,Water Bill,Utilities,-4472,-3347839,Debit
2024-06-08,UPI to Friend,Transfer,-6885,-3354724,Debit
2024-06-10,Doctor Visit,Health,-5316,-3360040,Debit
2024-12-12,Amazon Purchase,Shopping,-8585,-3368625,Debit
2025-01-11,Movie Tickets,Entertainment,-463,-3369088,Debit
2025-05-15,Salary Credit,Income,19591,-3349497,Credit
2024-12-27,Medical Store,Health,-5007,-3354504,Debit
2024-02-16,FD Interest,Savings Interest,13239,-3341265,Credit
2025-03-23,Interest Credit,Savings Interest,27056,-3314209,Credit
2024-03-23,Spotify,Entertainment,-6468,-3320677,Debit
2024-07-02,Flipkart Order,Shopping,-4543,-3325220,Debit
2024-07-09,Swiggy,Food,-1298,-3326518,Debit
2025-05-01,Bonus,Income,22499,-3304019,Credit
2025-01-08,Doctor Visit,Health,-5101,-3309120,Debit
2024-01-27,Movie Tickets,Entertainment,-8914,-3318034,Debit
2025-01-09,ATM Withdrawal,Cash,-2137,-3320171,Debit
2024-04-19,Doctor Visit,Health,-830,-3321001,Debit
2024-11-14,Received from Rahul,Transfer,-5390,-3326391,Debit
2024-07-25,Cash Deposit,Cash,-4983,-3331374,Debit
2024-12-31,Spotify,Entertainment,-8048,-3339422,Debit
2024-02-20,Myntra Shopping,Shopping,-187,-3339609,Debit
2024-04-05,Interest Credit,Savings Interest,6425,-3333184,Credit
2025-01-21,Electronics,Shopping,-3801,-3336985,Debit
2025-05-01,Myntra Shopping,Shopping,-5586,-3342571,Debit
2024-05-09,Uber Ride,Transport,-3500,-3346071,Debit
2024-01-20,Salary Credit,Income,24174,-3321897,Credit
2024-08-06,Freelance Payment,Income,21243,-3300654,Credit
2024-06-29,Cash Deposit,Cash,-4089,-3304743,Debit
2025-01-25,Interest Credit,Savings Interest,8803,-3295940,Credit
2024-08-13,Cash Deposit,Cash,-4844,-3300784,Debit
2025-03-05,Spotify,Entertainment,-780,-3301564,Debit
2024-04-12,Freelance Payment,Income,2899,-3298665,Credit
2024-04-27,Myntra Shopping,Shopping,-7022,-3305687,Debit
2025-05-15,Cafe Coffee Day,Food,-6027,-3311714,Debit
2024-01-12,Bank Transfer,Transfer,-1174,-3312888,Debit
2024-01-17,Restaurant Bill,Food,-3181,-3316069,Debit
2024-07-24,Uber Ride,Transport,-8794,-3324863,Debit
2024-09-21,FD Interest,Savings Interest,11246,-3313617,Credit
2024-11-03,Water Bill,Utilities,-6880,-3320497,Debit
2025-04-13,Spotify,Entertainment,-9486,-3329983,Debit
2024-06-12,Internet Recharge,Utilities,-5218,-3335201,Debit
2024-02-06,Uber Ride,Transport,-9005,-3344206,Debit
2025-02-15,YouTube Premium,Entertainment,-8414,-3352620,Debit
2024-08-15,Electronics,Shopping,-8732,-3361352,Debit
2024-10-30,Doctor Visit,Health,-2285,-3363637,Debit
2024-01-16,Interest Credit,Savings Interest,23300,-3340337,Credit
2024-01-30,Interest Credit,Savings Interest,29542,-3310795,Credit
2024-04-18,ATM Withdrawal,Cash,-9387,-3320182,Debit
2024-04-09,Freelance Payment,Income,29622,-3290560,Credit
2024-02-10,Movie Tickets,Entertainment,-4112,-3294672,Debit
2025-04-23,UPI to Friend,Transfer,-3285,-3297957,Debit
2024-05-16,Bank Transfer,Transfer,-4455,-3302412,Debit
2024-06-19,Interest Credit,Savings Interest,25880,-3276532,Credit
2024-02-04,Interest Credit,Savings Interest,17897,-3258635,Credit
2024-02-04,Flipkart Order,Shopping,-2287,-3260922,Debit
2025-04-17,Electronics,Shopping,-8940,-3269862,Debit
2024-02-27,Bank Transfer,Transfer,-2299,-3272161,Debit
2025-04-10,Bonus,Income,28033,-3244128,Credit
2024-12-15,ATM Withdrawal,Cash,-1635,-3245763,Debit
2024-03-31,Myntra Shopping,Shopping,-4567,-3250330,Debit
2024-08-01,Myntra Shopping,Shopping,-4946,-3255276,Debit
2024-06-06,Internet Recharge,Utilities,-5597,-3260873,Debit
2024-11-30,Refund,Income,4935,-3255938,Credit
2025-04-06,Myntra Shopping,Shopping,-6546,-3262484,Debit
2024-09-09,YouTube Premium,Entertainment,-2027,-3264511,Debit
2024-02-20,Movie Tickets,Entertainment,-7425,-3271936,Debit
2024-11-22,Interest Credit,Savings Interest,12440,-3259496,Credit
2024-12-18,Interest Credit,Savings Interest,26289,-3233207,Credit
2024-11-19,FD Interest,Savings Interest,12895,-3220312,Credit
2024-08-25,Petrol,Transport,-5827,-3226139,Debit
2025-03-06,ATM Withdrawal,Cash,-125,-3226264,Debit
2025-01-09,Movie Tickets,Entertainment,-5542,-3231806,Debit
2024-09-14,Water Bill,Utilities,-9050,-3240856,Debit
2024-10-31,Water Bill,Utilities,-9161,-3250017,Debit
2024-07-30,UPI to Friend,Transfer,-7408,-3257425,Debit
2024-02-03,Bonus,Income,17684,-3239741,Credit
2025-04-05,Salary Credit,Income,7836,-3231905,Credit
2024-05-07,Interest Credit,Savings Interest,27775,-3204130,Credit
2024-07-25,Amazon Purchase,Shopping,-6193,-3210323,Debit
2024-03-09,YouTube Premium,Entertainment,-4788,-3215111,Debit
2025-01-17,Received from Rahul,Transfer,-5169,-3220280,Debit
2024-08-13,Internet Recharge,Utilities,-3125,-3223405,Debit
2025-02-20,FD Interest,Savings Interest,1381,-3222024,Credit
2025-03-26,Bonus,Income,4034,-3217990,Credit
2024-10-04,Interest Credit,Savings Interest,22261,-3195729,Credit
2024-08-24,YouTube Premium,Entertainment,-552,-3196281,Debit
2024-03-04,Electricity Bill,Utilities,-9445,-3205726,Debit
2025-04-08,Internet Recharge,Utilities,-6934,-3212660,Debit
2024-06-06,Petrol,Transport,-2141,-3214801,Debit
2025-01-23,Electricity Bill,Utilities,-6866,-3221667,Debit
2024-05-19,Electricity Bill,Utilities,-5252,-3226919,Debit
2025-02-20,Cash Deposit,Cash,-1404,-3228323,Debit
2025-01-30,Amazon Purchase,Shopping,-9359,-3237682,Debit
2024-09-23,Medical Store,Health,-8064,-3245746,Debit
2025-05-09,Petrol,Transport,-4386,-3250132,Debit
2024-12-15,Cash Deposit,Cash,-5264,-3255396,Debit
2025-02-16,UPI to Friend,Transfer,-280,-3255676,Debit
2024-05-30,Electronics,Shopping,-9937,-3265613,Debit
2024-02-29,FD Interest,Savings Interest,13284,-3252329,Credit
2024-03-02,UPI to Friend,Transfer,-859,-3253188,Debit
2024-06-03,Refund,Income,28674,-3224514,Credit
2024-10-06,Internet Recharge,Utilities,-5235,-3229749,Debit
2024-06-03,Zomato Order,Food,-3347,-3233096,Debit
2025-03-28,Bonus,Income,25572,-3207524,Credit
2024-11-06,Myntra Shopping,Shopping,-3085,-3210609,Debit
2025-04-08,Myntra Shopping,Shopping,-9620,-3220229,Debit
2024-08-21,Salary Credit,Income,10579,-3209650,Credit
2024-09-14,Medical Store,Health,-5054,-3214704,Debit
2024-04-18,Zomato Order,Food,-1339,-3216043,Debit
2024-11-28,FD Interest,Savings Interest,23107,-3192936,Credit
2024-09-17,Train Ticket,Transport,-9072,-3202008,Debit
2024-07-09,Zomato Order,Food,-5194,-3207202,Debit
2024-07-24,Flipkart Order,Shopping,-4193,-3211395,Debit
2024-03-25,Internet Recharge,Utilities,-7999,-3219394,Debit
2025-01-15,Received from Rahul,Transfer,-4998,-3224392,Debit
2024-10-30,FD Interest,Savings Interest,13890,-3210502,Credit
2024-02-27,Cash Deposit,Cash,-5749,-3216251,Debit
2024-03-25,Uber Ride,Transport,-1235,-3217486,Debit
2024-02-14,Cash Deposit,Cash,-3724,-3221210,Debit
2024-08-27,Zomato Order,Food,-3034,-3224244,Debit
2025-04-01,Flipkart Order,Shopping,-7680,-3231924,Debit
2025-01-10,Received from Rahul,Transfer,-4720,-3236644,Debit
2025-03-03,Spotify,Entertainment,-6248,-3242892,Debit
2024-01-30,Bank Transfer,Transfer,-367,-3243259,Debit
2024-02-26,Amazon Purchase,Shopping,-9415,-3252674,Debit
2024-07-16,Refund,Income,22358,-3230316,Credit
2024-06-02,YouTube Premium,Entertainment,-7766,-3238082,Debit
2024-12-12,Bank Transfer,Transfer,-6554,-3244636,Debit
2024-12-22,Train Ticket,Transport,-8908,-3253544,Debit
2025-03-12,Uber Ride,Transport,-9940,-3263484,Debit
2024-07-28,Uber Ride,Transport,-7655,-3271139,Debit
2024-05-18,Swiggy,Food,-7732,-3278871,Debit
2024-11-21,Petrol,Transport,-6715,-3285586,Debit
2024-01-07,Cash Deposit,Cash,-8645,-3294231,Debit
2024-11-12,Water Bill,Utilities,-9659,-3303890,Debit
2024-11-06,FD Interest,Savings Interest,12282,-3291608,Credit
2025-01-17,Doctor Visit,Health,-4228,-3295836,Debit
2024-08-16,Petrol,Transport,-6607,-3302443,Debit
2024-07-05,Interest Credit,Savings Interest,3659,-3298784,Credit
2024-12-01,Movie Tickets,Entertainment,-7433,-3306217,Debit
2025-02-06,Doctor Visit,Health,-3934,-3310151,Debit
2025-01-15,Electricity Bill,Utilities,-2592,-3312743,Debit
2025-04-10,Zomato Order,Food,-6763,-3319506,Debit
2024-01-13,Freelance Payment,Income,22141,-3297365,Credit
2024-09-15,Restaurant Bill,Food,-3023,-3300388,Debit
2025-05-10,Electricity Bill,Utilities,-6809,-3307197,Debit
2024-03-08,Cafe Coffee Day,Food,-5857,-3313054,Debit
2024-01-08,Restaurant Bill,Food,-7591,-3320645,Debit
2024-09-02,Internet Recharge,Utilities,-5027,-3325672,Debit
2025-04-20,Cash Deposit,Cash,-4351,-3330023,Debit
2024-10-11,Cash Deposit,Cash,-883,-3330906,Debit
2024-11-05,Refund,Income,1277,-3329629,Credit
2024-08-05,Electronics,Shopping,-6167,-3335796,Debit
2024-10-26,Movie Tickets,Entertainment,-8376,-3344172,Debit
2025-04-20,FD Interest,Savings Interest,17835,-3326337,Credit
2025-04-08,Cash Deposit,Cash,-9360,-3335697,Debit
2025-04-17,Interest Credit,Savings Interest,18614,-3317083,Credit
2025-04-12,Internet Recharge,Utilities,-5088,-3322171,Debit
2024-11-17,Internet Recharge,Utilities,-1195,-3323366,Debit
2025-03-02,Amazon Purchase,Shopping,-6830,-3330196,Debit
2024-01-19,Internet Recharge,Utilities,-6738,-3336934,Debit
2025-05-03,ATM Withdrawal,Cash,-896,-3337830,Debit
2024-09-16,Restaurant Bill,Food,-7498,-3345328,Debit
2025-02-20,Cash Deposit,Cash,-7192,-3352520,Debit
2024-12-02,UPI to Friend,Transfer,-3469,-3355989,Debit
2024-10-08,UPI to Friend,Transfer,-6860,-3362849,Debit
2024-01-23,Zomato Order,Food,-9083,-3371932,Debit
2024-05-14,Refund,Income,21097,-3350835,Credit
2024-01-13,Electricity Bill,Utilities,-9683,-3360518,Debit
2024-09-21,FD Interest,Savings Interest,27785,-3332733,Credit
2024-07-20,Spotify,Entertainment,-9839,-3342572,Debit
2024-12-21,UPI to Friend,Transfer,-9533,-3352105,Debit
2024-09-23,Medical Store,Health,-6683,-3358788,Debit
2025-01-19,UPI to Friend,Transfer,-3643,-3362431,Debit
2024-05-02,UPI to Friend,Transfer,-2619,-3365050,Debit
2024-05-04,Train Ticket,Transport,-1168,-3366218,Debit
2024-10-15,Interest Credit,Savings Interest,27173,-3339045,Credit
2025-03-02,Flipkart Order,Shopping,-9612,-3348657,Debit
2024-02-09,FD Interest,Savings Interest,10865,-3337792,Credit
2024-08-10,Internet Recharge,Utilities,-9607,-3347399,Debit
2024-05-10,Restaurant Bill,Food,-4759,-3352158,Debit
2024-09-02,FD Interest,Savings Interest,26864,-3325294,Credit
2024-10-06,Received from Rahul,Transfer,-8254,-3333548,Debit
2024-07-10,Petrol,Transport,-375,-3333923,Debit
2024-04-09,Movie Tickets,Entertainment,-5434,-3339357,Debit
2024-10-16,Swiggy,Food,-9272,-3348629,Debit
2024-02-18,Water Bill,Utilities,-2166,-3350795,Debit
2024-02-29,Cash Deposit,Cash,-763,-3351558,Debit
2024-03-08,Medical Store,Health,-9277,-3360835,Debit
2025-05-07,Electronics,Shopping,-8753,-3369588,Debit
2024-10-09,ATM Withdrawal,Cash,-4031,-3373619,Debit
2024-05-31,Interest Credit,Savings Interest,10907,-3362712,Credit
2024-06-29,Interest Credit,Savings Interest,8230,-3354482,Credit
2025-02-02,Cash Deposit,Cash,-3905,-3358387,Debit
2024-01-04,Salary Credit,Income,14687,-3343700,Credit
2024-12-31,Zomato Order,Food,-6385,-3350085,Debit
2024-09-10,Refund,Income,9532,-3340553,Credit
2024-10-01,Bank Transfer,Transfer,-4216,-3344769,Debit
2024-07-23,Electronics,Shopping,-9962,-3354731,Debit
2024-02-20,Interest Credit,Savings Interest,21595,-3333136,Credit
2024-03-28,Cash Deposit,Cash,-4448,-3337584,Debit
2024-10-29,FD Interest,Savings Interest,16029,-3321555,Credit
2024-02-29,Uber Ride,Transport,-2645,-3324200,Debit
2024-07-19,Internet Recharge,Utilities,-292,-3324492,Debit
2024-04-17,Uber Ride,Transport,-5192,-3329684,Debit
2025-01-31,Interest Credit,Savings Interest,8475,-3321209,Credit
2024-01-06,Uber Ride,Transport,-1847,-3323056,Debit
2024-08-25,Cash Deposit,Cash,-9002,-3332058,Debit
2024-12-29,Doctor Visit,Health,-2403,-3334461,Debit
2024-05-23,Internet Recharge,Utilities,-7409,-3341870,Debit
2025-03-19,Internet Recharge,Utilities,-9094,-3350964,Debit
2024-02-10,Water Bill,Utilities,-5821,-3356785,Debit
2024-10-05,Electronics,Shopping,-318,-3357103,Debit
2024-08-25,ATM Withdrawal,Cash,-8657,-3365760,Debit
2025-03-10,Interest Credit,Savings Interest,1583,-3364177,Credit
2025-04-05,Petrol,Transport,-6523,-3370700,Debit
2024-09-30,Train Ticket,Transport,-1761,-3372461,Debit
2024-10-25,Doctor Visit,Health,-6767,-3379228,Debit
2025-05-14,UPI to Friend,Transfer,-4118,-3383346,Debit
2024-10-29,Uber Ride,Transport,-4781,-3388127,Debit
2024-10-25,Movie Tickets,Entertainment,-6675,-3394802,Debit
2024-10-07,Bank Transfer,Transfer,-820,-3395622,Debit
2024-08-26,Doctor Visit,Health,-3063,-3398685,Debit
2024-01-27,Received from Rahul,Transfer,-4869,-3403554,Debit
2024-03-02,Medical Store,Health,-6261,-3409815,Debit
2024-09-25,ATM Withdrawal,Cash,-328,-3410143,Debit
2024-09-25,Movie Tickets,Entertainment,-7246,-3417389,Debit
2024-11-28,Salary Credit,Income,29635,-3387754,Credit
2025-05-03,Received from Rahul,Transfer,-580,-3388334,Debit
2025-04-26,Cafe Coffee Day,Food,-8212,-3396546,Debit
2024-05-25,Bonus,Income,13979,-3382567,Credit
2024-12-18,Cash Deposit,Cash,-4771,-3387338,Debit
2025-01-07,Cash Deposit,Cash,-8741,-3396079,Debit
2024-07-14,Refund,Income,6862,-3389217,Credit
2024-09-12,Swiggy,Food,-6503,-3395720,Debit
2025-04-16,Medical Store,Health,-5457,-3401177,Debit
2024-04-15,Refund,Income,6583,-3394594,Credit
2024-07-15,Zomato Order,Food,-2552,-3397146,Debit
2025-01-04,Received from Rahul,Transfer,-9796,-3406942,Debit
2024-10-10,Salary Credit,Income,4060,-3402882,Credit
2024-07-25,Petrol,Transport,-8858,-3411740,Debit
2024-10-05,ATM Withdrawal,Cash,-1904,-3413644,Debit
2024-12-03,ATM Withdrawal,Cash,-8597,-3422241,Debit
2024-12-12,Bonus,Income,27402,-3394839,Credit
2025-05-08,FD Interest,Savings Interest,23566,-3371273,Credit
2024-03-28,UPI to Friend,Transfer,-6571,-3377844,Debit
2024-12-13,Interest Credit,Savings Interest,15183,-3362661,Credit
2024-07-12,Medical Store,Health,-9822,-3372483,Debit
2025-01-26,Salary Credit,Income,22369,-3350114,Credit
2025-04-24,Zomato Order,Food,-1492,-3351606,Debit
2024-04-11,Cash Deposit,Cash,-1749,-3353355,Debit
2025-05-05,ATM Withdrawal,Cash,-8426,-3361781,Debit
2024-08-30,Refund,Income,28106,-3333675,Credit
2024-05-20,Swiggy,Food,-4107,-3337782,Debit
2024-05-27,UPI to Friend,Transfer,-3150,-3340932,Debit
2025-02-08,Bank Transfer,Transfer,-159,-3341091,Debit
2024-06-09,ATM Withdrawal,Cash,-507,-3341598,Debit
2025-03-06,YouTube Premium,Entertainment,-7989,-3349587,Debit
2025-05-02,Interest Credit,Savings Interest,7123,-3342464,Credit
2024-08-31,Bank Transfer,Transfer,-7560,-3350024,Debit
2025-01-20,Salary Credit,Income,18918,-3331106,Credit
2024-09-19,Spotify,Entertainment,-1173,-3332279,Debit
2024-12-01,YouTube Premium,Entertainment,-3491,-3335770,Debit
2024-11-08,Received from Rahul,Transfer,-5587,-3341357,Debit
2024-11-19,Doctor Visit,Health,-5077,-3346434,Debit
2024-02-15,Received from Rahul,Transfer,-4077,-3350511,Debit
2024-10-17,Petrol,Transport,-5839,-3356350,Debit
2024-08-25,Uber Ride,Transport,-1767,-3358117,Debit
2025-04-29,Cash Deposit,Cash,-2134,-3360251,Debit
2024-09-05,FD Interest,Savings Interest,19637,-3340614,Credit
2025-04-01,UPI to Friend,Transfer,-9921,-3350535,Debit
2024-01-28,Interest Credit,Savings Interest,724,-3349811,Credit
2025-01-09,Medical Store,Health,-5670,-3355481,Debit
2024-01-28,Bank Transfer,Transfer,-3057,-3358538,Debit
2025-03-12,Bank Transfer,Transfer,-3464,-3362002,Debit
2024-04-22,Swiggy,Food,-1872,-3363874,Debit
2025-03-18,Internet Recharge,Utilities,-5028,-3368902,Debit
2024-07-23,Refund,Income,16371,-3352531,Credit
2024-07-11,Doctor Visit,Health,-5423,-3357954,Debit
2024-08-24,Flipkart Order,Shopping,-6919,-3364873,Debit
2024-11-30,Freelance Payment,Income,9594,-3355279,Credit
2025-04-09,Spotify,Entertainment,-985,-3356264,Debit
2024-12-08,Amazon Purchase,Shopping,-1314,-3357578,Debit
2024-01-30,Train Ticket,Transport,-8737,-3366315,Debit
2024-01-29,Petrol,Transport,-1597,-3367912,Debit
2024-05-05,Zomato Order,Food,-1035,-3368947,Debit
2024-03-26,Zomato Order,Food,-3536,-3372483,Debit
2024-03-01,FD Interest,Savings Interest,3478,-3369005,Credit
2024-08-30,ATM Withdrawal,Cash,-4233,-3373238,Debit
2024-04-07,Bank Transfer,Transfer,-2235,-3375473,Debit
2024-01-08,YouTube Premium,Entertainment,-3817,-3379290,Debit
2024-08-23,Swiggy,Food,-6525,-3385815,Debit
2024-01-28,Electricity Bill,Utilities,-4811,-3390626,Debit
2024-08-06,Salary Credit,Income,18621,-3372005,Credit
2024-08-01,Myntra Shopping,Shopping,-1918,-3373923,Debit
2024-02-07,Freelance Payment,Income,7303,-3366620,Credit
2024-12-29,Movie Tickets,Entertainment,-7459,-3374079,Debit
2024-02-06,Petrol,Transport,-4956,-3379035,Debit
2024-10-15,Flipkart Order,Shopping,-7208,-3386243,Debit
2024-08-09,Doctor Visit,Health,-1635,-3387878,Debit
2025-05-05,Electricity Bill,Utilities,-7452,-3395330,Debit
2024-02-09,FD Interest,Savings Interest,27231,-3368099,Credit
2024-05-19,Zomato Order,Food,-2857,-3370956,Debit
2024-04-29,Amazon Purchase,Shopping,-3627,-3374583,Debit
2024-06-29,UPI to Friend,Transfer,-3791,-3378374,Debit
2025-01-21,Internet Recharge,Utilities,-5412,-3383786,Debit
2024-12-24,Doctor Visit,Health,-5849,-3389635,Debit
2024-12-19,Salary Credit,Income,11743,-3377892,Credit
2024-06-04,Medical Store,Health,-9978,-3387870,Debit
2024-08-23,Medical Store,Health,-3020,-3390890,Debit
2024-07-30,Restaurant Bill,Food,-1178,-3392068,Debit
2025-02-11,Movie Tickets,Entertainment,-5178,-3397246,Debit
2024-09-08,Bank Transfer,Transfer,-1286,-3398532,Debit
2025-01-17,Internet Recharge,Utilities,-3865,-3402397,Debit
2024-02-17,Swiggy,Food,-3039,-3405436,Debit
2024-07-13,Flipkart Order,Shopping,-4438,-3409874,Debit
2024-03-24,Water Bill,Utilities,-3807,-3413681,Debit
2024-08-29,Cash Deposit,Cash,-5473,-3419154,Debit
2024-06-09,Amazon Purchase,Shopping,-3781,-3422935,Debit
2025-03-14,Received from Rahul,Transfer,-160,-3423095,Debit
2025-02-27,FD Interest,Savings Interest,5001,-3418094,Credit
2024-11-22,Interest Credit,Savings Interest,22344,-3395750,Credit
2025-05-10,Electricity Bill,Utilities,-3777,-3399527,Debit
2025-04-30,Train Ticket,Transport,-147,-3399674,Debit
2024-07-10,Doctor Visit,Health,-9977,-3409651,Debit
2024-12-14,Petrol,Transport,-3261,-3412912,Debit
2024-03-06,Swiggy,Food,-9250,-3422162,Debit
2024-02-17,Internet Recharge,Utilities,-7381,-3429543,Debit
2025-04-05,Internet Recharge,Utilities,-2356,-3431899,Debit
2024-08-22,Water Bill,Utilities,-5347,-3437246,Debit
2024-12-13,Doctor Visit,Health,-9059,-3446305,Debit
2024-06-08,Medical Store,Health,-3224,-3449529,Debit
2025-03-24,Movie Tickets,Entertainment,-9103,-3458632,Debit
2024-07-10,Bonus,Income,29166,-3429466,Credit
2024-05-03,Cash Deposit,Cash,-7003,-3436469,Debit
2024-04-19,FD Interest,Savings Interest,23234,-3413235,Credit
2024-05-12,FD Interest,Savings Interest,7660,-3405575,Credit
2024-03-20,Petrol,Transport,-9393,-3414968,Debit
2024-09-01,Restaurant Bill,Food,-2045,-3417013,Debit
2024-07-06,Spotify,Entertainment,-6140,-3423153,Debit
2024-04-07,Received from Rahul,Transfer,-3938,-3427091,Debit
2025-01-15,Restaurant Bill,Food,-9576,-3436667,Debit
2024-09-25,Doctor Visit,Health,-7086,-3443753,Debit
2024-10-12,YouTube Premium,Entertainment,-223,-3443976,Debit
2024-05-17,Bonus,Income,15435,-3428541,Credit
2024-11-18,Electronics,Shopping,-1164,-3429705,Debit
2025-04-07,Bonus,Income,23736,-3405969,Credit
2024-04-16,Flipkart Order,Shopping,-2208,-3408177,Debit
2025-05-11,Water Bill,Utilities,-2849,-3411026,Debit
2024-07-24,Interest Credit,Savings Interest,21740,-3389286,Credit
2024-04-22,Medical Store,Health,-5789,-3395075,Debit
2024-01-24,Amazon Purchase,Shopping,-6666,-3401741,Debit
2025-04-19,Refund,Income,18133,-3383608,Credit
2024-07-19,ATM Withdrawal,Cash,-6450,-3390058,Debit
2024-06-02,Restaurant Bill,Food,-1187,-3391245,Debit
2024-04-04,UPI to Friend,Transfer,-6884,-3398129,Debit
2025-01-08,Salary Credit,Income,2438,-3395691,Credit
2025-01-03,UPI to Friend,Transfer,-311,-3396002,Debit
2025-01-21,Cash Deposit,Cash,-3015,-3399017,Debit
2024-10-14,Interest Credit,Savings Interest,22467,-3376550,Credit
2024-04-09,YouTube Premium,Entertainment,-3984,-3380534,Debit
2024-08-27,ATM Withdrawal,Cash,-284,-3380818,Debit
2025-03-29,Salary Credit,Income,22294,-3358524,Credit
2025-01-09,Doctor Visit,Health,-6249,-3364773,Debit
2025-04-29,Flipkart Order,Shopping,-6925,-3371698,Debit
2025-03-29,ATM Withdrawal,Cash,-8935,-3380633,Debit
2025-04-01,Swiggy,Food,-8017,-3388650,Debit
2024-01-06,Movie Tickets,Entertainment,-6270,-3394920,Debit
2024-12-04,Uber Ride,Transport,-4542,-3399462,Debit
2024-04-05,Refund,Income,22775,-3376687,Credit
2024-10-02,Amazon Purchase,Shopping,-6283,-3382970,Debit
2025-02-25,Doctor Visit,Health,-9030,-3392000,Debit
2024-12-07,Myntra Shopping,Shopping,-8882,-3400882,Debit
2025-02-02,Internet Recharge,Utilities,-4462,-3405344,Debit
2024-07-31,Interest Credit,Savings Interest,10336,-3395008,Credit
2024-07-09,Received from Rahul,Transfer,-5371,-3400379,Debit
2024-03-15,Petrol,Transport,-9882,-3410261,Debit
2024-05-15,Bank Transfer,Transfer,-4782,-3415043,Debit
2024-04-26,Movie Tickets,Entertainment,-1870,-3416913,Debit
2024-04-15,Electricity Bill,Utilities,-7388,-3424301,Debit
2024-05-04,Restaurant Bill,Food,-5213,-3429514,Debit
2025-01-27,Medical Store,Health,-4953,-3434467,Debit
2024-08-15,Received from Rahul,Transfer,-7882,-3442349,Debit
2025-02-14,Electricity Bill,Utilities,-3711,-3446060,Debit
2024-01-01,Amazon Purchase,Shopping,-4374,-3450434,Debit
2024-06-15,Doctor Visit,Health,-1253,-3451687,Debit
2024-06-16,Train Ticket,Transport,-440,-3452127,Debit
2024-08-21,Water Bill,Utilities,-6303,-3458430,Debit
2024-10-10,Doctor Visit,Health,-7961,-3466391,Debit
2024-03-20,Myntra Shopping,Shopping,-6577,-3472968,Debit
2024-11-02,Water Bill,Utilities,-9908,-3482876,Debit
2024-03-07,Cafe Coffee Day,Food,-6096,-3488972,Debit
2024-02-21,Movie Tickets,Entertainment,-1640,-3490612,Debit
2024-03-21,Refund,Income,13321,-3477291,Credit
2024-08-28,Interest Credit,Savings Interest,29464,-3447827,Credit
2024-11-06,Bank Transfer,Transfer,-8015,-3455842,Debit
2025-05-02,Cash Deposit,Cash,-7075,-3462917,Debit
2024-09-08,Bonus,Income,19172,-3443745,Credit
2024-04-12,Uber Ride,Transport,-2878,-3446623,Debit
2024-04-22,Interest Credit,Savings Interest,17404,-3429219,Credit
2024-08-20,Medical Store,Health,-5243,-3434462,Debit
2024-09-11,Doctor Visit,Health,-8809,-3443271,Debit
2025-05-14,Restaurant Bill,Food,-8086,-3451357,Debit
2024-06-07,Interest Credit,Savings Interest,14961,-3436396,Credit
2025-01-25,Refund,Income,19420,-3416976,Credit
2024-07-11,Petrol,Transport,-2277,-3419253,Debit
2024-12-09,Cafe Coffee Day,Food,-9100,-3428353,Debit
2024-12-17,Train Ticket,Transport,-7801,-3436154,Debit
2025-04-24,Interest Credit,Savings Interest,21222,-3414932,Credit
2025-04-03,Internet Recharge,Utilities,-6498,-3421430,Debit
2025-03-29,Flipkart Order,Shopping,-5793,-3427223,Debit
2025-05-05,Zomato Order,Food,-8857,-3436080,Debit
2024-11-18,Cash Deposit,Cash,-1735,-3437815,Debit
2024-09-13,Train Ticket,Transport,-5754,-3443569,Debit
2024-12-17,Uber Ride,Transport,-3200,-3446769,Debit
2024-06-13,Restaurant Bill,Food,-296,-3447065,Debit
2024-05-22,Bank Transfer,Transfer,-1885,-3448950,Debit
2024-10-30,Salary Credit,Income,20545,-3428405,Credit
2024-03-29,Swiggy,Food,-4616,-3433021,Debit
2025-02-05,Electricity Bill,Utilities,-1809,-3434830,Debit
2024-08-13,Flipkart Order,Shopping,-1252,-3436082,Debit
2025-02-28,Interest Credit,Savings Interest,7316,-3428766,Credit
2024-05-25,Water Bill,Utilities,-2572,-3431338,Debit
2024-12-02,Flipkart Order,Shopping,-9218,-3440556,Debit
2024-06-20,YouTube Premium,Entertainment,-2820,-3443376,Debit
2024-07-09,Electronics,Shopping,-3971,-3447347,Debit
2024-07-02,Doctor Visit,Health,-8400,-3455747,Debit
2025-01-24,FD Interest,Savings Interest,21579,-3434168,Credit
2024-02-21,Myntra Shopping,Shopping,-9814,-3443982,Debit
2024-06-12,Refund,Income,3364,-3440618,Credit
2024-12-21,UPI to Friend,Transfer,-1934,-3442552,Debit
2025-02-13,Spotify,Entertainment,-521,-3443073,Debit
2024-09-27,Bonus,Income,21278,-3421795,Credit
2024-05-18,Flipkart Order,Shopping,-4015,-3425810,Debit
2024-06-06,Movie Tickets,Entertainment,-3734,-3429544,Debit
2024-07-21,Cash Deposit,Cash,-4538,-3434082,Debit
2024-05-25,Internet Recharge,Utilities,-5881,-3439963,Debit
2025-05-09,YouTube Premium,Entertainment,-6256,-3446219,Debit
2024-09-30,Bank Transfer,Transfer,-9824,-3456043,Debit
2024-10-25,Medical Store,Health,-7588,-3463631,Debit
2025-03-11,Doctor Visit,Health,-2824,-3466455,Debit
2024-03-29,Interest Credit,Savings Interest,14222,-3452233,Credit
2024-07-20,Received from Rahul,Transfer,-1111,-3453344,Debit
2024-09-13,Doctor Visit,Health,-5758,-3459102,Debit
2025-04-25,Electronics,Shopping,-3551,-3462653,Debit
2025-01-30,Movie Tickets,Entertainment,-9783,-3472436,Debit
2025-02-16,Doctor Visit,Health,-9344,-3481780,Debit
2024-08-06,UPI to Friend,Transfer,-6429,-3488209,Debit
2025-04-22,Cash Deposit,Cash,-8555,-3496764,Debit
2024-04-14,Spotify,Entertainment,-8410,-3505174,Debit
2025-04-21,Freelance Payment,Income,16261,-3488913,Credit
2024-02-15,Petrol,Transport,-5645,-3494558,Debit
2024-11-03,Internet Recharge,Utilities,-1678,-3496236,Debit
2024-05-14,Uber Ride,Transport,-3278,-3499514,Debit
2025-03-31,Bank Transfer,Transfer,-8036,-3507550,Debit
2025-03-06,Salary Credit,Income,16848,-3490702,Credit
2025-01-15,Water Bill,Utilities,-8598,-3499300,Debit
2025-05-05,Salary Credit,Income,11645,-3487655,Credit
2024-02-23,Cafe Coffee Day,Food,-1667,-3489322,Debit
2024-03-12,Doctor Visit,Health,-9943,-3499265,Debit
2024-08-20,Interest Credit,Savings Interest,20146,-3479119,Credit
2024-11-07,Uber Ride,Transport,-187,-3479306,Debit
2024-07-04,Train Ticket,Transport,-8949,-3488255,Debit
2024-01-13,Flipkart Order,Shopping,-3685,-3491940,Debit
2025-01-08,Electricity Bill,Utilities,-7494,-3499434,Debit
2024-11-02,UPI to Friend,Transfer,-8662,-3508096,Debit
2024-12-15,Refund,Income,9585,-3498511,Credit
2025-01-31,Refund,Income,21929,-3476582,Credit
2025-02-14,Electricity Bill,Utilities,-3218,-3479800,Debit
2024-04-17,ATM Withdrawal,Cash,-2870,-3482670,Debit
2024-07-29,ATM Withdrawal,Cash,-809,-3483479,Debit
2024-01-27,Petrol,Transport,-8209,-3491688,Debit
2025-01-22,Electricity Bill,Utilities,-5432,-3497120,Debit
2024-10-16,Received from Rahul,Transfer,-2387,-3499507,Debit
2024-10-04,Train Ticket,Transport,-2963,-3502470,Debit
2024-03-14,Spotify,Entertainment,-7537,-3510007,Debit
2024-03-14,Freelance Payment,Income,26472,-3483535,Credit
2025-01-15,Cash Deposit,Cash,-8130,-3491665,Debit
2024-08-06,Medical Store,Health,-2509,-3494174,Debit
2024-09-12,Internet Recharge,Utilities,-1823,-3495997,Debit
2024-03-21,Water Bill,Utilities,-7771,-3503768,Debit
2024-02-06,Doctor Visit,Health,-1429,-3505197,Debit
2024-11-06,Interest Credit,Savings Interest,7462,-3497735,Credit
2024-10-14,Interest Credit,Savings Interest,28363,-3469372,Credit
2025-02-24,Medical Store,Health,-8997,-3478369,Debit
2024-08-03,Petrol,Transport,-9082,-3487451,Debit
2024-05-25,Bonus,Income,14945,-3472506,Credit
2025-03-20,Salary Credit,Income,8717,-3463789,Credit
2024-12-08,Flipkart Order,Shopping,-6242,-3470031,Debit
2024-09-09,Electricity Bill,Utilities,-3953,-3473984,Debit
2024-10-30,Cafe Coffee Day,Food,-9527,-3483511,Debit
2024-03-04,Swiggy,Food,-1995,-3485506,Debit
2024-04-29,Freelance Payment,Income,24450,-3461056,Credit
2024-07-20,Salary Credit,Income,18496,-3442560,Credit
2024-11-18,Water Bill,Utilities,-6021,-3448581,Debit
2025-01-24,Doctor Visit,Health,-7038,-3455619,Debit
2024-11-15,Amazon Purchase,Shopping,-2566,-3458185,Debit
2025-03-16,Bonus,Income,6165,-3452020,Credit
2025-02-18,Petrol,Transport,-6224,-3458244,Debit
2024-01-12,Restaurant Bill,Food,-4964,-3463208,Debit
2025-02-25,Restaurant Bill,Food,-1745,-3464953,Debit
2025-04-13,Interest Credit,Savings Interest,22627,-3442326,Credit
2024-10-15,Movie Tickets,Entertainment,-7169,-3449495,Debit
2024-03-03,Doctor Visit,Health,-6688,-3456183,Debit
2025-02-18,YouTube Premium,Entertainment,-7532,-3463715,Debit
2024-07-29,Uber Ride,Transport,-3163,-3466878,Debit
2024-03-26,Water Bill,Utilities,-1990,-3468868,Debit
2024-06-07,Refund,Income,579,-3468289,Credit
2025-04-20,Medical Store,Health,-4505,-3472794,Debit
2024-05-19,Flipkart Order,Shopping,-646,-3473440,Debit
2024-08-27,Electricity Bill,Utilities,-132,-3473572,Debit
2024-04-24,Swiggy,Food,-7054,-3480626,Debit
2025-01-22,Bank Transfer,Transfer,-194,-3480820,Debit
2024-12-17,Freelance Payment,Income,4737,-3476083,Credit
2024-12-22,Cash Deposit,Cash,-9710,-3485793,Debit
2024-08-11,Uber Ride,Transport,-5309,-3491102,Debit
2024-04-07,Petrol,Transport,-8953,-3500055,Debit
2024-05-08,Train Ticket,Transport,-146,-3500201,Debit
2025-03-11,UPI to Friend,Transfer,-1296,-3501497,Debit
2025-03-11,Uber Ride,Transport,-2231,-3503728,Debit
2025-01-26,FD Interest,Savings Interest,8135,-3495593,Credit
2024-06-27,Spotify,Entertainment,-8630,-3504223,Debit
2024-02-12,ATM Withdrawal,Cash,-4785,-3509008,Debit
2024-11-13,Interest Credit,Savings Interest,1501,-3507507,Credit
2024-09-20,Swiggy,Food,-899,-3508406,Debit
2024-03-18,Salary Credit,Income,6085,-3502321,Credit
2024-05-10,Refund,Income,3730,-3498591,Credit
2024-04-25,Bank Transfer,Transfer,-5112,-3503703,Debit
2025-02-02,Received from Rahul,Transfer,-4941,-3508644,Debit
2024-04-04,Cash Deposit,Cash,-810,-3509454,Debit
2025-02-15,UPI to Friend,Transfer,-1607,-3511061,Debit
2024-03-26,Freelance Payment,Income,18516,-3492545,Credit
2024-12-23,Train Ticket,Transport,-7785,-3500330,Debit
2024-11-02,Internet Recharge,Utilities,-9285,-3509615,Debit
2025-01-16,Restaurant Bill,Food,-1145,-3510760,Debit
2024-09-12,Restaurant Bill,Food,-1681,-3512441,Debit
2024-05-04,ATM Withdrawal,Cash,-4021,-3516462,Debit
2024-12-22,Uber Ride,Transport,-8419,-3524881,Debit
2024-10-07,Interest Credit,Savings Interest,18839,-3506042,Credit
2025-04-27,Interest Credit,Savings Interest,14268,-3491774,Credit
2024-05-02,Myntra Shopping,Shopping,-5329,-3497103,Debit
2024-09-25,Zomato Order,Food,-4424,-3501527,Debit
2024-07-30,Medical Store,Health,-4678,-3506205,Debit
2025-02-05,Water Bill,Utilities,-1913,-3508118,Debit
2025-02-23,Freelance Payment,Income,10859,-3497259,Credit
2024-04-06,Cafe Coffee Day,Food,-6326,-3503585,Debit
2025-02-03,Petrol,Transport,-2221,-3505806,Debit
2024-12-28,Cafe Coffee Day,Food,-5730,-3511536,Debit
2024-01-25,Electronics,Shopping,-4164,-3515700,Debit
2024-05-25,YouTube Premium,Entertainment,-1007,-3516707,Debit
2024-07-02,Freelance Payment,Income,17343,-3499364,Credit
2025-05-01,YouTube Premium,Entertainment,-9824,-3509188,Debit
2024-11-08,Interest Credit,Savings Interest,12689,-3496499,Credit
2024-12-09,Cafe Coffee Day,Food,-9862,-3506361,Debit
2024-03-04,Movie Tickets,Entertainment,-2427,-3508788,Debit
2025-04-20,Interest Credit,Savings Interest,6299,-3502489,Credit
2024-06-22,FD Interest,Savings Interest,16299,-3486190,Credit
2025-03-04,Uber Ride,Transport,-7121,-3493311,Debit
2024-03-10,Zomato Order,Food,-4677,-3497988,Debit
2024-07-28,FD Interest,Savings Interest,16946,-3481042,Credit
2024-11-11,Electronics,Shopping,-587,-3481629,Debit
2024-06-16,Spotify,Entertainment,-7360,-3488989,Debit
2025-04-28,Cash Deposit,Cash,-3949,-3492938,Debit
2024-12-23,FD Interest,Savings Interest,19045,-3473893,Credit
2024-06-16,ATM Withdrawal,Cash,-6027,-3479920,Debit
2024-10-27,Cash Deposit,Cash,-228,-3480148,Debit
2025-04-29,ATM Withdrawal,Cash,-8354,-3488502,Debit
2024-03-13,Received from Rahul,Transfer,-6379,-3494881,Debit
2024-11-15,Cash Deposit,Cash,-9827,-3504708,Debit
2024-10-28,Freelance Payment,Income,3116,-3501592,Credit
2024-11-08,Medical Store,Health,-5173,-3506765,Debit
2024-11-09,Movie Tickets,Entertainment,-1179,-3507944,Debit
2024-01-31,Interest Credit,Savings Interest,12595,-3495349,Credit
2025-01-19,Swiggy,Food,-8852,-3504201,Debit
2025-04-19,Cafe Coffee Day,Food,-2633,-3506834,Debit
2024-10-25,Restaurant Bill,Food,-1873,-3508707,Debit
2025-02-07,Myntra Shopping,Shopping,-2017,-3510724,Debit
2024-04-27,Freelance Payment,Income,16977,-3493747,Credit
2025-03-20,Cash Deposit,Cash,-8086,-3501833,Debit
2024-06-11,UPI to Friend,Transfer,-1503,-3503336,Debit
2025-03-01,Interest Credit,Savings Interest,7850,-3495486,Credit
2024-08-29,Cafe Coffee Day,Food,-2129,-3497615,Debit
2024-02-27,Amazon Purchase,Shopping,-251,-3497866,Debit
2024-01-21,Petrol,Transport,-528,-3498394,Debit
2024-06-24,Salary Credit,Income,8090,-3490304,Credit
2025-02-22,Petrol,Transport,-8092,-3498396,Debit
2024-01-19,Interest Credit,Savings Interest,19575,-3478821,Credit
2025-01-25,Cash Deposit,Cash,-8377,-3487198,Debit
2024-05-04,Interest Credit,Savings Interest,5505,-3481693,Credit
2024-03-02,Cash Deposit,Cash,-8337,-3490030,Debit
2024-10-05,Flipkart Order,Shopping,-5445,-3495475,Debit
2025-01-17,Medical Store,Health,-5347,-3500822,Debit
2024-12-04,Bank Transfer,Transfer,-5538,-3506360,Debit
2025-03-16,Refund,Income,17061,-3489299,Credit
2025-05-02,YouTube Premium,Entertainment,-1486,-3490785,Debit
2024-08-03,Received from Rahul,Transfer,-6030,-3496815,Debit
2024-08-20,Cafe Coffee Day,Food,-6381,-3503196,Debit
2024-01-29,Electricity Bill,Utilities,-9796,-3512992,Debit
2024-02-24,Doctor Visit,Health,-7705,-3520697,Debit
2024-10-03,Uber Ride,Transport,-7848,-3528545,Debit
2024-03-23,Medical Store,Health,-6244,-3534789,Debit
2025-02-08,Zomato Order,Food,-6250,-3541039,Debit
2025-02-18,Restaurant Bill,Food,-844,-3541883,Debit
2024-06-01,Water Bill,Utilities,-7039,-3548922,Debit
2025-04-24,Train Ticket,Transport,-8255,-3557177,Debit
2025-02-15,Medical Store,Health,-6029,-3563206,Debit
2024-08-06,Spotify,Entertainment,-5527,-3568733,Debit
2024-01-22,Zomato Order,Food,-2000,-3570733,Debit
2024-12-21,Internet Recharge,Utilities,-173,-3570906,Debit
2024-08-14,ATM Withdrawal,Cash,-3809,-3574715,Debit
2025-02-18,Cash Deposit,Cash,-5996,-3580711,Debit
2024-12-16,Zomato Order,Food,-143,-3580854,Debit
2024-01-07,Zomato Order,Food,-5788,-3586642,Debit
2024-11-26,Water Bill,Utilities,-3532,-3590174,Debit
2024-09-28,Spotify,Entertainment,-7706,-3597880,Debit
2024-10-01,Restaurant Bill,Food,-5444,-3603324,Debit
2024-08-01,Bank Transfer,Transfer,-9389,-3612713,Debit
2024-07-30,Swiggy,Food,-3183,-3615896,Debit
2024-03-12,Interest Credit,Savings Interest,3812,-3612084,Credit
2024-11-15,Medical Store,Health,-7393,-3619477,Debit
2025-04-11,UPI to Friend,Transfer,-9991,-3629468,Debit
2024-06-11,UPI to Friend,Transfer,-718,-3630186,Debit
2024-05-12,YouTube Premium,Entertainment,-2451,-3632637,Debit
2024-03-04,Received from Rahul,Transfer,-3130,-3635767,Debit
2025-01-04,Petrol,Transport,-1050,-3636817,Debit
2024-01-31,Freelance Payment,Income,3389,-3633428,Credit
2024-05-18,Freelance Payment,Income,12825,-3620603,Credit
2025-02-22,Movie Tickets,Entertainment,-7420,-3628023,Debit
2024-04-21,Electronics,Shopping,-6972,-3634995,Debit
2024-10-12,UPI to Friend,Transfer,-6761,-3641756,Debit
2024-06-18,Petrol,Transport,-6751,-3648507,Debit
2024-03-11,Water Bill,Utilities,-8845,-3657352,Debit
2024-04-16,Myntra Shopping,Shopping,-717,-3658069,Debit
2025-01-22,Received from Rahul,Transfer,-7760,-3665829,Debit
2025-01-17,Bank Transfer,Transfer,-8914,-3674743,Debit
2025-02-26,ATM Withdrawal,Cash,-6294,-3681037,Debit
2025-03-27,Amazon Purchase,Shopping,-826,-3681863,Debit
2025-03-26,Medical Store,Health,-1655,-3683518,Debit
2024-12-26,Received from Rahul,Transfer,-4100,-3687618,Debit
2025-05-09,Doctor Visit,Health,-8670,-3696288,Debit
2024-08-16,Water Bill,Utilities,-3029,-3699317,Debit
2025-01-20,Train Ticket,Transport,-9832,-3709149,Debit
2024-04-29,ATM Withdrawal,Cash,-862,-3710011,Debit
2024-11-07,Interest Credit,Savings Interest,28222,-3681789,Credit
2024-12-06,Received from Rahul,Transfer,-2012,-3683801,Debit
2024-06-06,Spotify,Entertainment,-2145,-3685946,Debit
2025-01-13,ATM Withdrawal,Cash,-6331,-3692277,Debit
2024-04-18,Zomato Order,Food,-5638,-3697915,Debit
2025-02-09,Spotify,Entertainment,-3394,-3701309,Debit
2024-03-29,Spotify,Entertainment,-1822,-3703131,Debit
2024-01-19,Cash Deposit,Cash,-4548,-3707679,Debit
2024-07-27,Swiggy,Food,-7040,-3714719,Debit
2024-04-23,Water Bill,Utilities,-8336,-3723055,Debit
2024-03-31,Water Bill,Utilities,-7476,-3730531,Debit
2024-05-29,Restaurant Bill,Food,-7912,-3738443,Debit
2024-09-07,Cash Deposit,Cash,-1750,-3740193,Debit
2024-12-18,Spotify,Entertainment,-1631,-3741824,Debit
2024-03-23,Train Ticket,Transport,-8900,-3750724,Debit
2024-11-02,Salary Credit,Income,7800,-3742924,Credit
2025-01-18,FD Interest,Savings Interest,29485,-3713439,Credit
2024-10-07,Spotify,Entertainment,-496,-3713935,Debit
2025-02-18,Water Bill,Utilities,-602,-3714537,Debit
2024-10-11,Cash Deposit,Cash,-8450,-3722987,Debit
2025-05-12,Restaurant Bill,Food,-8965,-3731952,Debit
2024-12-23,Spotify,Entertainment,-8972,-3740924,Debit
2024-09-16,Restaurant Bill,Food,-2385,-3743309,Debit
2025-04-15,Medical Store,Health,-3495,-3746804,Debit
2024-12-15,Cash Deposit,Cash,-6376,-3753180,Debit
2025-01-09,Movie Tickets,Entertainment,-6560,-3759740,Debit
2025-02-01,FD Interest,Savings Interest,28911,-3730829,Credit
2024-01-08,ATM Withdrawal,Cash,-3331,-3734160,Debit
2024-11-18,Interest Credit,Savings Interest,20421,-3713739,Credit
2025-02-14,Uber Ride,Transport,-7499,-3721238,Debit
2025-02-19,Restaurant Bill,Food,-1327,-3722565,Debit
2024-10-09,Zomato Order,Food,-2637,-3725202,Debit
2024-05-06,Uber Ride,Transport,-8791,-3733993,Debit
2024-09-07,Doctor Visit,Health,-3162,-3737155,Debit
2025-01-21,Medical Store,Health,-8459,-3745614,Debit
2024-04-10,Medical Store,Health,-2127,-3747741,Debit
2024-07-26,UPI to Friend,Transfer,-7627,-3755368,Debit
2025-04-23,Interest Credit,Savings Interest,14262,-3741106,Credit
2025-04-22,Received from Rahul,Transfer,-4830,-3745936,Debit
2025-03-12,Flipkart Order,Shopping,-6602,-3752538,Debit
2025-05-10,Salary Credit,Income,29530,-3723008,Credit
2025-02-27,Received from Rahul,Transfer,-6793,-3729801,Debit
2024-12-21,Cafe Coffee Day,Food,-1827,-3731628,Debit
2024-01-25,Zomato Order,Food,-3243,-3734871,Debit
2024-09-25,YouTube Premium,Entertainment,-2671,-3737542,Debit
2024-01-25,Salary Credit,Income,18276,-3719266,Credit
2024-10-06,Freelance Payment,Income,18493,-3700773,Credit
2024-06-29,Movie Tickets,Entertainment,-7248,-3708021,Debit
2024-10-28,Electricity Bill,Utilities,-4878,-3712899,Debit
2025-01-28,Cash Deposit,Cash,-8570,-3721469,Debit
2024-09-04,Medical Store,Health,-7206,-3728675,Debit
2024-11-08,Flipkart Order,Shopping,-4795,-3733470,Debit
2024-06-13,Petrol,Transport,-145,-3733615,Debit
2024-07-23,FD Interest,Savings Interest,22221,-3711394,Credit
2025-03-28,FD Interest,Savings Interest,19111,-3692283,Credit
2025-01-05,Interest Credit,Savings Interest,2361,-3689922,Credit
2024-11-24,FD Interest,Savings Interest,17237,-3672685,Credit
2025-03-30,Swiggy,Food,-1504,-3674189,Debit
2024-09-11,FD Interest,Savings Interest,28791,-3645398,Credit
2024-10-20,Interest Credit,Savings Interest,5737,-3639661,Credit
2024-11-01,FD Interest,Savings Interest,3008,-3636653,Credit
2024-06-13,Cash Deposit,Cash,-2988,-3639641,Debit
2024-09-25,Interest Credit,Savings Interest,15900,-3623741,Credit
2025-01-22,Internet Recharge,Utilities,-2487,-3626228,Debit
2024-08-12,Doctor Visit,Health,-9977,-3636205,Debit
2025-02-08,Cafe Coffee Day,Food,-9525,-3645730,Debit
2024-07-02,Amazon Purchase,Shopping,-1529,-3647259,Debit
2024-03-14,Interest Credit,Savings Interest,19794,-3627465,Credit
2025-03-30,Refund,Income,12628,-3614837,Credit
2024-06-15,Cash Deposit,Cash,-5235,-3620072,Debit
2024-04-28,Medical Store,Health,-638,-3620710,Debit
2025-03-19,Myntra Shopping,Shopping,-438,-3621148,Debit
2024-05-28,Bank Transfer,Transfer,-3258,-3624406,Debit
2024-05-01,Internet Recharge,Utilities,-7923,-3632329,Debit
2024-10-19,Petrol,Transport,-3817,-3636146,Debit
2024-06-25,Cash Deposit,Cash,-5805,-3641951,Debit
2024-10-04,Cash Deposit,Cash,-8888,-3650839,Debit
2024-07-27,Medical Store,Health,-7229,-3658068,Debit
2024-09-11,Cafe Coffee Day,Food,-7167,-3665235,Debit
2024-08-03,Salary Credit,Income,19800,-3645435,Credit
2025-04-26,Cash Deposit,Cash,-8019,-3653454,Debit
2025-03-22,Uber Ride,Transport,-3102,-3656556,Debit
2024-02-17,Flipkart Order,Shopping,-1195,-3657751,Debit
2024-05-13,Train Ticket,Transport,-2441,-3660192,Debit
2024-02-01,Uber Ride,Transport,-3657,-3663849,Debit
2024-01-18,Interest Credit,Savings Interest,17190,-3646659,Credit
2025-01-16,Spotify,Entertainment,-1749,-3648408,Debit
2025-02-28,Doctor Visit,Health,-6242,-3654650,Debit
2024-07-01,Restaurant Bill,Food,-9815,-3664465,Debit
2024-05-15,ATM Withdrawal,Cash,-7005,-3671470,Debit
2024-03-02,Zomato Order,Food,-7792,-3679262,Debit
2024-10-03,Restaurant Bill,Food,-4292,-3683554,Debit
2024-07-19,Swiggy,Food,-8164,-3691718,Debit
2024-05-31,Bonus,Income,2663,-3689055,Credit
2024-04-07,Bonus,Income,26072,-3662983,Credit
2024-08-28,Zomato Order,Food,-6921,-3669904,Debit
2025-02-04,Internet Recharge,Utilities,-8974,-3678878,Debit
2024-01-14,Uber Ride,Transport,-476,-3679354,Debit
2024-06-03,Bank Transfer,Transfer,-7863,-3687217,Debit
2024-03-28,Medical Store,Health,-2909,-3690126,Debit
2025-03-18,Electricity Bill,Utilities,-9664,-3699790,Debit
2024-11-04,Interest Credit,Savings Interest,5197,-3694593,Credit
2024-07-09,Flipkart Order,Shopping,-9055,-3703648,Debit
2024-03-19,FD Interest,Savings Interest,7305,-3696343,Credit
2024-04-30,Movie Tickets,Entertainment,-1904,-3698247,Debit
2024-05-20,UPI to Friend,Transfer,-920,-3699167,Debit
2025-04-04,Medical Store,Health,-6076,-3705243,Debit
2024-07-21,Petrol,Transport,-1156,-3706399,Debit
2024-04-11,FD Interest,Savings Interest,8647,-3697752,Credit
2025-03-29,Electricity Bill,Utilities,-4212,-3701964,Debit
2024-12-06,Medical Store,Health,-9403,-3711367,Debit
2024-03-25,Swiggy,Food,-511,-3711878,Debit
2025-03-31,YouTube Premium,Entertainment,-4745,-3716623,Debit
2024-03-31,Medical Store,Health,-7207,-3723830,Debit
2024-08-12,Spotify,Entertainment,-8402,-3732232,Debit
2024-03-16,Electricity Bill,Utilities,-6508,-3738740,Debit
2024-07-23,Interest Credit,Savings Interest,25564,-3713176,Credit
2024-07-31,Swiggy,Food,-3282,-3716458,Debit
2024-05-03,Petrol,Transport,-7132,-3723590,Debit
2024-12-13,Cash Deposit,Cash,-8713,-3732303,Debit
2024-03-11,Cafe Coffee Day,Food,-1666,-3733969,Debit
2024-01-12,FD Interest,Savings Interest,15696,-3718273,Credit
2025-02-24,FD Interest,Savings Interest,24150,-3694123,Credit
2025-03-26,Electricity Bill,Utilities,-8609,-3702732,Debit
2024-01-16,Cafe Coffee Day,Food,-9451,-3712183,Debit
2024-09-03,Medical Store,Health,-8432,-3720615,Debit
2025-03-15,Zomato Order,Food,-8871,-3729486,Debit
2024-01-15,Water Bill,Utilities,-2934,-3732420,Debit
2024-08-03,ATM Withdrawal,Cash,-3524,-3735944,Debit
2024-11-07,Petrol,Transport,-7352,-3743296,Debit
2024-02-20,Refund,Income,16178,-3727118,Credit
2025-02-23,Water Bill,Utilities,-210,-3727328,Debit
2024-08-02,FD Interest,Savings Interest,1964,-3725364,Credit
2024-12-08,Amazon Purchase,Shopping,-2191,-3727555,Debit
2025-03-28,Internet Recharge,Utilities,-5196,-3732751,Debit
2025-04-23,UPI to Friend,Transfer,-7002,-3739753,Debit
2025-04-13,Refund,Income,9488,-3730265,Credit
2024-02-16,Internet Recharge,Utilities,-7873,-3738138,Debit
2024-02-29,Freelance Payment,Income,26028,-3712110,Credit
2024-08-02,Flipkart Order,Shopping,-2024,-3714134,Debit
2024-08-27,UPI to Friend,Transfer,-6086,-3720220,Debit
2024-09-06,Flipkart Order,Shopping,-7331,-3727551,Debit
2024-09-22,Salary Credit,Income,2325,-3725226,Credit
2025-02-08,Petrol,Transport,-1000,-3726226,Debit
2024-08-17,FD Interest,Savings Interest,17313,-3708913,Credit
2024-10-15,Cash Deposit,Cash,-1243,-3710156,Debit
2025-02-24,Water Bill,Utilities,-4432,-3714588,Debit
2024-08-07,FD Interest,Savings Interest,12462,-3702126,Credit
2025-04-05,Bank Transfer,Transfer,-8055,-3710181,Debit
2024-06-20,Movie Tickets,Entertainment,-4701,-3714882,Debit
2024-08-25,Swiggy,Food,-2704,-3717586,Debit
2024-04-13,Cash Deposit,Cash,-7286,-3724872,Debit
2024-05-04,Swiggy,Food,-8168,-3733040,Debit
2024-06-24,Internet Recharge,Utilities,-3680,-3736720,Debit
2024-04-16,Spotify,Entertainment,-3382,-3740102,Debit
2024-11-10,Water Bill,Utilities,-1763,-3741865,Debit
2025-01-16,Interest Credit,Savings Interest,26627,-3715238,Credit
2024-08-02,Interest Credit,Savings Interest,18764,-3696474,Credit
2024-08-13,Cash Deposit,Cash,-6971,-3703445,Debit
2024-01-22,Restaurant Bill,Food,-9285,-3712730,Debit
2025-04-21,Restaurant Bill,Food,-9022,-3721752,Debit
2024-08-06,Received from Rahul,Transfer,-6446,-3728198,Debit
2024-01-07,Cash Deposit,Cash,-9220,-3737418,Debit
2024-08-09,Restaurant Bill,Food,-838,-3738256,Debit
2025-01-06,Received from Rahul,Transfer,-8027,-3746283,Debit
2024-05-28,Refund,Income,16650,-3729633,Credit
2024-03-23,YouTube Premium,Entertainment,-6062,-3735695,Debit
2024-09-10,Train Ticket,Transport,-8133,-3743828,Debit
2025-01-07,Petrol,Transport,-1684,-3745512,Debit
2024-02-28,Doctor Visit,Health,-5974,-3751486,Debit
2024-04-11,Electricity Bill,Utilities,-6215,-3757701,Debit
2024-07-29,Petrol,Transport,-4062,-3761763,Debit
2024-01-03,Electricity Bill,Utilities,-7261,-3769024,Debit
2024-08-09,Spotify,Entertainment,-8265,-3777289,Debit
2024-12-26,Train Ticket,Transport,-6072,-3783361,Debit
2024-08-01,Amazon Purchase,Shopping,-9896,-3793257,Debit
2024-04-13,Interest Credit,Savings Interest,18925,-3774332,Credit
2024-08-18,Refund,Income,21103,-3753229,Credit
2025-02-25,ATM Withdrawal,Cash,-3355,-3756584,Debit
2024-02-22,UPI to Friend,Transfer,-8317,-3764901,Debit
2024-11-08,Myntra Shopping,Shopping,-9623,-3774524,Debit
2024-12-12,Medical Store,Health,-7998,-3782522,Debit
2024-09-24,Uber Ride,Transport,-1997,-3784519,Debit
2024-10-06,ATM Withdrawal,Cash,-8967,-3793486,Debit
2024-11-26,Interest Credit,Savings Interest,19668,-3773818,Credit
2025-01-29,Train Ticket,Transport,-3358,-3777176,Debit
2025-03-28,Uber Ride,Transport,-4131,-3781307,Debit
2025-01-25,Swiggy,Food,-236,-3781543,Debit
2025-05-12,Restaurant Bill,Food,-8199,-3789742,Debit
2024-12-27,ATM Withdrawal,Cash,-1096,-3790838,Debit
2025-01-28,Received from Rahul,Transfer,-6206,-3797044,Debit
2025-02-21,Movie Tickets,Entertainment,-462,-3797506,Debit
2024-08-25,Salary Credit,Income,14025,-3783481,Credit
2025-01-10,Medical Store,Health,-3324,-3786805,Debit
2024-03-24,Swiggy,Food,-5948,-3792753,Debit
2024-08-10,YouTube Premium,Entertainment,-7531,-3800284,Debit
2024-05-21,Medical Store,Health,-7101,-3807385,Debit
2024-06-21,Cash Deposit,Cash,-7775,-3815160,Debit
2024-06-20,Electronics,Shopping,-539,-3815699,Debit
2024-04-17,Myntra Shopping,Shopping,-3387,-3819086,Debit
2024-09-08,UPI to Friend,Transfer,-1086,-3820172,Debit
2024-02-27,Petrol,Transport,-6292,-3826464,Debit
2024-08-29,Swiggy,Food,-6283,-3832747,Debit
2025-04-27,ATM Withdrawal,Cash,-3244,-3835991,Debit
2024-03-09,Bank Transfer,Transfer,-9199,-3845190,Debit
2024-06-30,Restaurant Bill,Food,-8277,-3853467,Debit
2025-04-28,Water Bill,Utilities,-1528,-3854995,Debit
2024-02-10,Amazon Purchase,Shopping,-972,-3855967,Debit
2024-12-29,Bonus,Income,15394,-3840573,Credit
2025-03-26,ATM Withdrawal,Cash,-1353,-3841926,Debit
2024-03-06,Salary Credit,Income,11196,-3830730,Credit
2024-12-27,Received from Rahul,Transfer,-7930,-3838660,Debit
2024-10-26,Zomato Order,Food,-4544,-3843204,Debit
2025-01-25,FD Interest,Savings Interest,9792,-3833412,Credit
2024-11-05,Doctor Visit,Health,-6605,-3840017,Debit
2025-04-01,Spotify,Entertainment,-2550,-3842567,Debit
2025-04-13,Received from Rahul,Transfer,-6172,-3848739,Debit
2024-11-12,UPI to Friend,Transfer,-8750,-3857489,Debit
2025-04-05,Myntra Shopping,Shopping,-5172,-3862661,Debit
2025-03-22,Water Bill,Utilities,-9844,-3872505,Debit
2024-04-15,Myntra Shopping,Shopping,-5442,-3877947,Debit
2024-12-10,Uber Ride,Transport,-4795,-3882742,Debit
2025-01-15,ATM Withdrawal,Cash,-2477,-3885219,Debit
2024-05-17,Cafe Coffee Day,Food,-2499,-3887718,Debit
2025-04-21,FD Interest,Savings Interest,8534,-3879184,Credit
2025-04-10,Restaurant Bill,Food,-9469,-3888653,Debit
2024-06-19,Doctor Visit,Health,-4009,-3892662,Debit
2024-12-14,Internet Recharge,Utilities,-2414,-3895076,Debit
2025-04-02,FD Interest,Savings Interest,7758,-3887318,Credit
2025-01-19,Medical Store,Health,-8081,-3895399,Debit
2025-02-08,Myntra Shopping,Shopping,-8402,-3903801,Debit
2025-02-20,Doctor Visit,Health,-3185,-3906986,Debit
2024-08-31,Medical Store,Health,-4819,-3911805,Debit
2025-02-12,ATM Withdrawal,Cash,-5018,-3916823,Debit
2024-06-01,Refund,Income,26576,-3890247,Credit
2025-04-21,YouTube Premium,Entertainment,-4144,-3894391,Debit
2024-12-09,Cash Deposit,Cash,-4839,-3899230,Debit
2024-01-29,Movie Tickets,Entertainment,-516,-3899746,Debit
2024-07-15,Cash Deposit,Cash,-4270,-3904016,Debit
2024-03-19,Electronics,Shopping,-7860,-3911876,Debit
2025-02-08,Swiggy,Food,-6489,-3918365,Debit
2024-11-05,Refund,Income,17630,-3900735,Credit
2024-12-30,UPI to Friend,Transfer,-8614,-3909349,Debit
2025-05-14,FD Interest,Savings Interest,26833,-3882516,Credit
2024-06-19,Petrol,Transport,-1132,-3883648,Debit
2024-03-10,Medical Store,Health,-7825,-3891473,Debit
2024-03-16,Salary Credit,Income,10561,-3880912,Credit
2024-01-12,Spotify,Entertainment,-5797,-3886709,Debit
2025-03-23,ATM Withdrawal,Cash,-4716,-3891425,Debit
2025-05-06,Doctor Visit,Health,-8964,-3900389,Debit
2024-04-06,Doctor Visit,Health,-4831,-3905220,Debit
2024-03-19,Doctor Visit,Health,-9238,-3914458,Debit
2025-02-19,ATM Withdrawal,Cash,-8649,-3923107,Debit
2024-09-13,Myntra Shopping,Shopping,-4901,-3928008,Debit
2024-07-04,Spotify,Entertainment,-792,-3928800,Debit
2024-07-05,FD Interest,Savings Interest,20235,-3908565,Credit
2025-03-10,Cafe Coffee Day,Food,-994,-3909559,Debit
2024-03-02,Medical Store,Health,-485,-3910044,Debit
2024-04-17,Received from Rahul,Transfer,-2662,-3912706,Debit
2024-08-09,ATM Withdrawal,Cash,-3070,-3915776,Debit
2024-07-02,Water Bill,Utilities,-9106,-3924882,Debit
2025-01-17,Water Bill,Utilities,-412,-3925294,Debit
2024-09-30,YouTube Premium,Entertainment,-8500,-3933794,Debit
2025-01-15,Cafe Coffee Day,Food,-5950,-3939744,Debit
2025-01-09,Flipkart Order,Shopping,-9743,-3949487,Debit
2024-02-04,Bank Transfer,Transfer,-6515,-3956002,Debit
2024-07-04,Spotify,Entertainment,-9084,-3965086,Debit
2025-03-06,Freelance Payment,Income,29288,-3935798,Credit
2024-12-10,Cash Deposit,Cash,-8137,-3943935,Debit
2024-03-26,Freelance Payment,Income,26090,-3917845,Credit
2024-03-19,FD Interest,Savings Interest,13871,-3903974,Credit
2024-01-08,Myntra Shopping,Shopping,-5452,-3909426,Debit
2024-10-17,Water Bill,Utilities,-7806,-3917232,Debit
2024-03-27,Bank Transfer,Transfer,-3108,-3920340,Debit
2024-12-10,Amazon Purchase,Shopping,-390,-3920730,Debit
2025-04-09,Salary Credit,Income,25351,-3895379,Credit
2024-08-26,Electricity Bill,Utilities,-2776,-3898155,Debit
2025-02-17,Cash Deposit,Cash,-8922,-3907077,Debit
2025-03-24,Received from Rahul,Transfer,-9296,-3916373,Debit
2024-11-21,Water Bill,Utilities,-1450,-3917823,Debit
2024-08-14,Spotify,Entertainment,-9242,-3927065,Debit
2024-04-19,Electronics,Shopping,-7057,-3934122,Debit
2024-08-10,Swiggy,Food,-4713,-3938835,Debit
2024-05-02,Salary Credit,Income,10579,-3928256,Credit
2024-05-09,Interest Credit,Savings Interest,16115,-3912141,Credit
2024-12-14,Movie Tickets,Entertainment,-4777,-3916918,Debit
2024-03-03,Water Bill,Utilities,-4441,-3921359,Debit
2024-05-05,ATM Withdrawal,Cash,-7885,-3929244,Debit
2024-12-09,Electronics,Shopping,-5335,-3934579,Debit
2025-01-05,Internet Recharge,Utilities,-8735,-3943314,Debit
2024-12-04,Cash Deposit,Cash,-5230,-3948544,Debit
2024-06-23,YouTube Premium,Entertainment,-9133,-3957677,Debit
2024-07-01,Interest Credit,Savings Interest,20687,-3936990,Credit
2024-12-12,Amazon Purchase,Shopping,-3918,-3940908,Debit
2025-05-09,Bonus,Income,11632,-3929276,Credit
2024-10-15,Cafe Coffee Day,Food,-7051,-3936327,Debit
2024-04-20,Interest Credit,Savings Interest,14946,-3921381,Credit
2024-03-19,Interest Credit,Savings Interest,18309,-3903072,Credit
2024-01-24,Received from Rahul,Transfer,-167,-3903239,Debit
2025-04-16,Zomato Order,Food,-6036,-3909275,Debit
2024-02-01,FD Interest,Savings Interest,719,-3908556,Credit
2024-10-24,FD Interest,Savings Interest,4354,-3904202,Credit
2024-11-23,Zomato Order,Food,-7085,-3911287,Debit
2024-01-23,Interest Credit,Savings Interest,18852,-3892435,Credit
2025-02-28,FD Interest,Savings Interest,24669,-3867766,Credit
2025-04-23,Spotify,Entertainment,-9306,-3877072,Debit
2025-05-06,Doctor Visit,Health,-2643,-3879715,Debit
2025-01-09,Doctor Visit,Health,-8405,-3888120,Debit
2024-05-20,ATM Withdrawal,Cash,-738,-3888858,Debit
2024-04-16,Cafe Coffee Day,Food,-3056,-3891914,Debit
2024-06-13,UPI to Friend,Transfer,-8466,-3900380,Debit
2024-04-23,Freelance Payment,Income,28380,-3872000,Credit
2025-03-17,Train Ticket,Transport,-6076,-3878076,Debit
2024-06-24,ATM Withdrawal,Cash,-8688,-3886764,Debit
2024-05-27,Bonus,Income,11615,-3875149,Credit
2025-04-11,Restaurant Bill,Food,-2336,-3877485,Debit
2024-04-11,Medical Store,Health,-8702,-3886187,Debit
2024-06-13,Received from Rahul,Transfer,-6810,-3892997,Debit
2024-09-29,UPI to Friend,Transfer,-469,-3893466,Debit
2024-04-01,Interest Credit,Savings Interest,12854,-3880612,Credit
2025-04-21,ATM Withdrawal,Cash,-8692,-3889304,Debit
2025-03-25,Cafe Coffee Day,Food,-5622,-3894926,Debit
2024-11-13,Water Bill,Utilities,-316,-3895242,Debit
2024-08-30,Water Bill,Utilities,-8576,-3903818,Debit
2025-03-02,Internet Recharge,Utilities,-9375,-3913193,Debit
2024-08-31,Cash Deposit,Cash,-3196,-3916389,Debit
2024-04-25,Bank Transfer,Transfer,-2336,-3918725,Debit
2024-12-13,Internet Recharge,Utilities,-3781,-3922506,Debit
2024-11-02,FD Interest,Savings Interest,3374,-3919132,Credit
2024-03-23,Doctor Visit,Health,-1652,-3920784,Debit
2024-01-25,Bank Transfer,Transfer,-4359,-3925143,Debit
2024-07-26,UPI to Friend,Transfer,-7941,-3933084,Debit
2025-04-18,Doctor Visit,Health,-8873,-3941957,Debit
2024-01-26,Train Ticket,Transport,-8748,-3950705,Debit
2024-03-30,Petrol,Transport,-3605,-3954310,Debit
2025-03-11,Movie Tickets,Entertainment,-3564,-3957874,Debit
2025-05-13,ATM Withdrawal,Cash,-8404,-3966278,Debit
2024-08-14,ATM Withdrawal,Cash,-4613,-3970891,Debit
2024-01-20,Received from Rahul,Transfer,-1757,-3972648,Debit
2024-01-27,Received from Rahul,Transfer,-8545,-3981193,Debit
2024-01-18,Medical Store,Health,-574,-3981767,Debit
2024-05-15,FD Interest,Savings Interest,12875,-3968892,Credit
2024-06-20,Restaurant Bill,Food,-3730,-3972622,Debit
2024-07-09,Restaurant Bill,Food,-572,-3973194,Debit
2024-01-30,Received from Rahul,Transfer,-3405,-3976599,Debit
2024-08-27,UPI to Friend,Transfer,-1449,-3978048,Debit
2025-02-20,Cash Deposit,Cash,-7391,-3985439,Debit
2024-02-08,Freelance Payment,Income,914,-3984525,Credit
2024-10-06,Received from Rahul,Transfer,-5580,-3990105,Debit
2024-06-01,Train Ticket,Transport,-8467,-3998572,Debit
2024-01-03,Medical Store,Health,-1207,-3999779,Debit
2024-05-02,Spotify,Entertainment,-4678,-4004457,Debit
2025-05-07,Interest Credit,Savings Interest,8598,-3995859,Credit
2024-10-22,Interest Credit,Savings Interest,28839,-3967020,Credit
2024-05-15,Received from Rahul,Transfer,-3842,-3970862,Debit
2024-12-24,YouTube Premium,Entertainment,-5426,-3976288,Debit
2024-03-18,Restaurant Bill,Food,-6479,-3982767,Debit
2024-01-19,Restaurant Bill,Food,-6846,-3989613,Debit
2024-10-09,YouTube Premium,Entertainment,-2862,-3992475,Debit
2024-10-21,Train Ticket,Transport,-7060,-3999535,Debit
2024-03-18,ATM Withdrawal,Cash,-4098,-4003633,Debit
2024-09-08,Cafe Coffee Day,Food,-4153,-4007786,Debit
2024-05-04,ATM Withdrawal,Cash,-6441,-4014227,Debit
2024-07-01,Amazon Purchase,Shopping,-2749,-4016976,Debit
2024-06-01,UPI to Friend,Transfer,-6938,-4023914,Debit
2024-07-21,ATM Withdrawal,Cash,-7623,-4031537,Debit
2024-01-28,Bonus,Income,19734,-4011803,Credit
2024-01-07,Freelance Payment,Income,12358,-3999445,Credit
2024-09-04,Doctor Visit,Health,-8071,-4007516,Debit
2024-03-15,Uber Ride,Transport,-7269,-4014785,Debit
2024-06-03,Interest Credit,Savings Interest,27334,-3987451,Credit
2024-11-01,Spotify,Entertainment,-4147,-3991598,Debit
2024-02-24,FD Interest,Savings Interest,15875,-3975723,Credit
2024-08-27,Cafe Coffee Day,Food,-9965,-3985688,Debit
2025-03-11,Internet Recharge,Utilities,-8304,-3993992,Debit
2024-10-14,Restaurant Bill,Food,-2415,-3996407,Debit
2024-06-17,Swiggy,Food,-3829,-4000236,Debit
2024-10-15,ATM Withdrawal,Cash,-4186,-4004422,Debit
2024-09-29,Bank Transfer,Transfer,-4931,-4009353,Debit
2024-12-23,Cash Deposit,Cash,-9077,-4018430,Debit
2024-07-06,Spotify,Entertainment,-7530,-4025960,Debit
2024-09-29,Cash Deposit,Cash,-8688,-4034648,Debit
2024-08-31,Medical Store,Health,-2891,-4037539,Debit
2024-07-16,UPI to Friend,Transfer,-1358,-4038897,Debit
2024-03-02,Flipkart Order,Shopping,-8669,-4047566,Debit
2024-02-05,Received from Rahul,Transfer,-938,-4048504,Debit
2024-09-12,Cash Deposit,Cash,-3310,-4051814,Debit
2024-04-05,Refund,Income,19038,-4032776,Credit
2024-04-17,YouTube Premium,Entertainment,-9813,-4042589,Debit
2024-08-18,Internet Recharge,Utilities,-5253,-4047842,Debit
2024-04-29,Zomato Order,Food,-3421,-4051263,Debit
2025-03-29,Cafe Coffee Day,Food,-6073,-4057336,Debit
2025-03-18,Petrol,Transport,-9782,-4067118,Debit
2024-08-28,Interest Credit,Savings Interest,1072,-4066046,Credit
2024-03-19,Received from Rahul,Transfer,-1618,-4067664,Debit
2024-11-10,FD Interest,Savings Interest,10609,-4057055,Credit
2024-06-17,Medical Store,Health,-8537,-4065592,Debit
2025-01-21,Water Bill,Utilities,-1476,-4067068,Debit
2025-04-21,Cash Deposit,Cash,-5410,-4072478,Debit
2025-03-01,Train Ticket,Transport,-6948,-4079426,Debit
2025-03-04,FD Interest,Savings Interest,6160,-4073266,Credit
2024-01-04,Flipkart Order,Shopping,-6120,-4079386,Debit
2024-04-23,Salary Credit,Income,24303,-4055083,Credit
2024-05-26,FD Interest,Savings Interest,7542,-4047541,Credit
2024-02-22,Water Bill,Utilities,-6289,-4053830,Debit
2025-04-13,ATM Withdrawal,Cash,-1721,-4055551,Debit
2025-01-12,ATM Withdrawal,Cash,-8330,-4063881,Debit
2024-06-09,Medical Store,Health,-173,-4064054,Debit
2025-02-16,Restaurant Bill,Food,-8648,-4072702,Debit
2024-02-15,Swiggy,Food,-8253,-4080955,Debit
2024-11-17,Electricity Bill,Utilities,-9723,-4090678,Debit
2024-01-24,Train Ticket,Transport,-2916,-4093594,Debit
2024-11-05,Medical Store,Health,-5473,-4099067,Debit
2024-09-01,Bonus,Income,19706,-4079361,Credit
2025-02-05,Medical Store,Health,-9347,-4088708,Debit
2024-08-22,Swiggy,Food,-9853,-4098561,Debit
2024-12-21,Flipkart Order,Shopping,-9403,-4107964,Debit
2024-05-27,Zomato Order,Food,-3903,-4111867,Debit
2025-03-25,Bank Transfer,Transfer,-3347,-4115214,Debit
2024-09-15,Medical Store,Health,-5142,-4120356,Debit
2024-11-04,ATM Withdrawal,Cash,-8978,-4129334,Debit
2025-01-14,Electricity Bill,Utilities,-8212,-4137546,Debit
2024-12-10,Water Bill,Utilities,-7831,-4145377,Debit
2024-06-23,Doctor Visit,Health,-2383,-4147760,Debit
2024-06-25,YouTube Premium,Entertainment,-267,-4148027,Debit
2024-12-13,Restaurant Bill,Food,-7052,-4155079,Debit
2024-08-17,Amazon Purchase,Shopping,-8449,-4163528,Debit
2024-12-25,UPI to Friend,Transfer,-1816,-4165344,Debit
2024-04-17,Bonus,Income,6812,-4158532,Credit
2025-02-25,Salary Credit,Income,6006,-4152526,Credit
2024-10-07,Freelance Payment,Income,29742,-4122784,Credit
2025-04-26,UPI to Friend,Transfer,-1253,-4124037,Debit
2024-08-28,FD Interest,Savings Interest,14422,-4109615,Credit
2024-06-05,Medical Store,Health,-3477,-4113092,Debit
2024-07-17,Restaurant Bill,Food,-6004,-4119096,Debit
2024-09-14,Petrol,Transport,-4504,-4123600,Debit
2024-09-06,Zomato Order,Food,-7765,-4131365,Debit
2024-08-28,Cash Deposit,Cash,-5858,-4137223,Debit
2024-04-16,Cafe Coffee Day,Food,-1801,-4139024,Debit
2024-12-20,Petrol,Transport,-8066,-4147090,Debit
2024-10-22,Myntra Shopping,Shopping,-3321,-4150411,Debit
2024-02-20,Electronics,Shopping,-6700,-4157111,Debit
2024-02-15,Electronics,Shopping,-5692,-4162803,Debit
2025-03-21,UPI to Friend,Transfer,-1532,-4164335,Debit
2024-01-01,ATM Withdrawal,Cash,-3688,-4168023,Debit
2024-01-19,Bonus,Income,20057,-4147966,Credit
2024-08-14,Flipkart Order,Shopping,-9110,-4157076,Debit
2024-09-12,Water Bill,Utilities,-8356,-4165432,Debit
2024-10-08,Doctor Visit,Health,-6582,-4172014,Debit
2024-05-08,Cash Deposit,Cash,-402,-4172416,Debit
2024-09-05,Uber Ride,Transport,-1426,-4173842,Debit
2024-04-02,Cash Deposit,Cash,-7197,-4181039,Debit
2024-02-29,Train Ticket,Transport,-6195,-4187234,Debit
2024-02-05,Restaurant Bill,Food,-9621,-4196855,Debit
2025-03-02,Cash Deposit,Cash,-4878,-4201733,Debit
2024-08-12,Amazon Purchase,Shopping,-2103,-4203836,Debit
2024-09-27,Cafe Coffee Day,Food,-2572,-4206408,Debit
2025-03-06,Spotify,Entertainment,-2059,-4208467,Debit
2025-03-29,Cash Deposit,Cash,-2761,-4211228,Debit
2024-05-28,Electronics,Shopping,-5515,-4216743,Debit
2025-04-07,Swiggy,Food,-4533,-4221276,Debit
2024-03-22,Doctor Visit,Health,-4191,-4225467,Debit
2024-05-10,Internet Recharge,Utilities,-7741,-4233208,Debit
2024-05-01,Interest Credit,Savings Interest,12713,-4220495,Credit
2025-04-09,Movie Tickets,Entertainment,-1870,-4222365,Debit
2025-02-26,Restaurant Bill,Food,-7018,-4229383,Debit
2025-01-28,Myntra Shopping,Shopping,-5773,-4235156,Debit
2024-03-02,Water Bill,Utilities,-2400,-4237556,Debit
2025-03-02,Interest Credit,Savings Interest,27219,-4210337,Credit
2024-06-18,Electricity Bill,Utilities,-2968,-4213305,Debit
2024-07-28,Myntra Shopping,Shopping,-2486,-4215791,Debit
2024-08-14,Water Bill,Utilities,-9521,-4225312,Debit
2024-08-25,Cash Deposit,Cash,-9073,-4234385,Debit
2024-10-10,Bonus,Income,2882,-4231503,Credit
2025-04-10,UPI to Friend,Transfer,-6165,-4237668,Debit
2024-11-11,Refund,Income,17358,-4220310,Credit
2025-04-16,Electricity Bill,Utilities,-8815,-4229125,Debit
2024-11-01,Internet Recharge,Utilities,-4901,-4234026,Debit
2024-05-28,ATM Withdrawal,Cash,-2714,-4236740,Debit
2024-05-25,Received from Rahul,Transfer,-4877,-4241617,Debit
2024-09-27,Bank Transfer,Transfer,-896,-4242513,Debit
2024-06-14,YouTube Premium,Entertainment,-6748,-4249261,Debit
2024-03-12,Cash Deposit,Cash,-9234,-4258495,Debit
2025-05-13,Swiggy,Food,-745,-4259240,Debit
2024-09-09,Medical Store,Health,-7387,-4266627,Debit
2024-07-06,ATM Withdrawal,Cash,-6582,-4273209,Debit
2024-08-03,Water Bill,Utilities,-2667,-4275876,Debit
2024-04-22,Electronics,Shopping,-7129,-4283005,Debit
2025-01-15,Movie Tickets,Entertainment,-567,-4283572,Debit
2024-02-13,Interest Credit,Savings Interest,12621,-4270951,Credit
2024-04-21,UPI to Friend,Transfer,-2670,-4273621,Debit
2024-12-25,Salary Credit,Income,7970,-4265651,Credit
2025-01-03,ATM Withdrawal,Cash,-2266,-4267917,Debit
2024-08-15,Myntra Shopping,Shopping,-9583,-4277500,Debit
2024-04-03,Medical Store,Health,-2454,-4279954,Debit
2024-12-05,Uber Ride,Transport,-4618,-4284572,Debit
2024-01-02,UPI to Friend,Transfer,-6993,-4291565,Debit
2024-09-19,Bank Transfer,Transfer,-1854,-4293419,Debit
2024-11-18,FD Interest,Savings Interest,28655,-4264764,Credit
2024-11-20,Internet Recharge,Utilities,-5650,-4270414,Debit
2025-02-16,Doctor Visit,Health,-3629,-4274043,Debit
2025-02-07,Electronics,Shopping,-9327,-4283370,Debit
2025-03-16,FD Interest,Savings Interest,25018,-4258352,Credit
2024-03-31,Received from Rahul,Transfer,-8163,-4266515,Debit
2025-04-07,Myntra Shopping,Shopping,-912,-4267427,Debit
2025-03-25,Electronics,Shopping,-4525,-4271952,Debit
2024-12-22,Petrol,Transport,-7245,-4279197,Debit
2024-08-18,Electricity Bill,Utilities,-2501,-4281698,Debit
2024-12-24,Freelance Payment,Income,7410,-4274288,Credit
2025-01-02,Bank Transfer,Transfer,-4904,-4279192,Debit
2024-03-01,ATM Withdrawal,Cash,-2075,-4281267,Debit
2024-01-06,Interest Credit,Savings Interest,9621,-4271646,Credit
2024-11-07,Cash Deposit,Cash,-6035,-4277681,Debit
2024-02-15,Spotify,Entertainment,-7496,-4285177,Debit
2024-08-21,Cafe Coffee Day,Food,-8491,-4293668,Debit
2024-05-29,Freelance Payment,Income,18298,-4275370,Credit
2024-03-19,Received from Rahul,Transfer,-7241,-4282611,Debit
2024-02-14,Spotify,Entertainment,-1904,-4284515,Debit
2024-02-12,Cash Deposit,Cash,-8294,-4292809,Debit
2024-11-04,UPI to Friend,Transfer,-8864,-4301673,Debit
2025-02-03,Restaurant Bill,Food,-4144,-4305817,Debit
2024-09-25,Interest Credit,Savings Interest,7417,-4298400,Credit
2024-03-26,YouTube Premium,Entertainment,-7045,-4305445,Debit
2024-03-04,ATM Withdrawal,Cash,-9388,-4314833,Debit
2024-05-22,Cash Deposit,Cash,-1156,-4315989,Debit
2024-12-22,Swiggy,Food,-2507,-4318496,Debit
2024-03-14,Spotify,Entertainment,-9407,-4327903,Debit
2024-11-09,Cash Deposit,Cash,-713,-4328616,Debit
2024-08-05,Doctor Visit,Health,-1393,-4330009,Debit
2024-06-26,Electricity Bill,Utilities,-6506,-4336515,Debit
2024-04-12,Electricity Bill,Utilities,-6696,-4343211,Debit
2024-09-17,Zomato Order,Food,-8367,-4351578,Debit
2024-11-01,Petrol,Transport,-7888,-4359466,Debit
2024-05-27,Doctor Visit,Health,-7054,-4366520,Debit
2025-04-14,Train Ticket,Transport,-154,-4366674,Debit
2025-02-12,Swiggy,Food,-9187,-4375861,Debit
2025-01-15,FD Interest,Savings Interest,23545,-4352316,Credit
2024-09-21,Doctor Visit,Health,-2794,-4355110,Debit
2025-05-12,Amazon Purchase,Shopping,-4958,-4360068,Debit
2024-02-29,ATM Withdrawal,Cash,-9509,-4369577,Debit
2024-05-16,Cafe Coffee Day,Food,-7512,-4377089,Debit
2025-05-01,Doctor Visit,Health,-4173,-4381262,Debit
2025-01-25,Freelance Payment,Income,12614,-4368648,Credit
2024-04-18,Electricity Bill,Utilities,-7323,-4375971,Debit
2024-02-22,Water Bill,Utilities,-1370,-4377341,Debit
2024-07-16,Received from Rahul,Transfer,-9511,-4386852,Debit
2025-03-15,Myntra Shopping,Shopping,-9804,-4396656,Debit
2024-04-13,Medical Store,Health,-9067,-4405723,Debit
2024-10-05,Electricity Bill,Utilities,-9966,-4415689,Debit
2024-11-15,YouTube Premium,Entertainment,-1008,-4416697,Debit
2024-03-17,ATM Withdrawal,Cash,-3971,-4420668,Debit
2024-10-07,Amazon Purchase,Shopping,-9069,-4429737,Debit
2024-01-02,Interest Credit,Savings Interest,18248,-4411489,Credit
2024-07-22,Swiggy,Food,-9589,-4421078,Debit
2024-10-10,Received from Rahul,Transfer,-2306,-4423384,Debit
2025-03-03,Flipkart Order,Shopping,-7813,-4431197,Debit
2024-12-19,Medical Store,Health,-6360,-4437557,Debit
2024-10-14,Train Ticket,Transport,-2610,-4440167,Debit
2024-11-10,Zomato Order,Food,-9779,-4449946,Debit
2025-03-28,YouTube Premium,Entertainment,-2402,-4452348,Debit
2024-10-29,Movie Tickets,Entertainment,-4497,-4456845,Debit
2025-04-02,Swiggy,Food,-9618,-4466463,Debit
2024-03-19,Doctor Visit,Health,-5356,-4471819,Debit
2024-07-05,Electricity Bill,Utilities,-7323,-4479142,Debit
2024-05-29,Petrol,Transport,-1931,-4481073,Debit
2024-08-03,Salary Credit,Income,26200,-4454873,Credit
2024-03-22,Train Ticket,Transport,-8568,-4463441,Debit
2024-11-21,Medical Store,Health,-7949,-4471390,Debit
2024-02-05,Zomato Order,Food,-8321,-4479711,Debit
2025-05-13,Medical Store,Health,-189,-4479900,Debit
2025-04-08,Water Bill,Utilities,-4962,-4484862,Debit
2025-01-02,Received from Rahul,Transfer,-5984,-4490846,Debit
2025-03-09,FD Interest,Savings Interest,9329,-4481517,Credit
2024-07-18,Petrol,Transport,-1319,-4482836,Debit
2024-08-05,Water Bill,Utilities,-9383,-4492219,Debit
2024-12-18,Flipkart Order,Shopping,-632,-4492851,Debit
2025-05-14,Doctor Visit,Health,-866,-4493717,Debit
2024-09-20,ATM Withdrawal,Cash,-4085,-4497802,Debit
2025-01-15,Spotify,Entertainment,-7651,-4505453,Debit
2024-02-15,UPI to Friend,Transfer,-6052,-4511505,Debit
2024-04-10,Petrol,Transport,-4039,-4515544,Debit
2025-02-28,UPI to Friend,Transfer,-6080,-4521624,Debit
2024-10-08,Amazon Purchase,Shopping,-847,-4522471,Debit
2024-03-14,ATM Withdrawal,Cash,-1510,-4523981,Debit
2025-03-24,Refund,Income,4489,-4519492,Credit
2024-11-14,Bonus,Income,7607,-4511885,Credit
2024-11-04,Train Ticket,Transport,-4441,-4516326,Debit
2024-11-04,Myntra Shopping,Shopping,-6645,-4522971,Debit
2025-03-26,Myntra Shopping,Shopping,-7368,-4530339,Debit
2024-12-28,Flipkart Order,Shopping,-6891,-4537230,Debit
2025-01-12,Doctor Visit,Health,-8830,-4546060,Debit
2024-08-05,Doctor Visit,Health,-8528,-4554588,Debit
2024-12-11,Internet Recharge,Utilities,-7654,-4562242,Debit
2024-08-14,UPI to Friend,Transfer,-2886,-4565128,Debit
2024-09-07,Restaurant Bill,Food,-6696,-4571824,Debit
2024-11-25,Cafe Coffee Day,Food,-919,-4572743,Debit
2025-01-27,ATM Withdrawal,Cash,-8849,-4581592,Debit
2025-04-08,Medical Store,Health,-262,-4581854,Debit
2024-10-26,Uber Ride,Transport,-1887,-4583741,Debit
2024-12-23,UPI to Friend,Transfer,-6835,-4590576,Debit
2025-04-17,Train Ticket,Transport,-4902,-4595478,Debit
2024-12-04,Train Ticket,Transport,-5946,-4601424,Debit
2024-12-01,Restaurant Bill,Food,-8040,-4609464,Debit
2025-04-04,Electricity Bill,Utilities,-3840,-4613304,Debit
2024-09-07,Doctor Visit,Health,-4838,-4618142,Debit
2025-03-24,Cash Deposit,Cash,-1805,-4619947,Debit
2025-03-09,Cafe Coffee Day,Food,-576,-4620523,Debit
2024-03-21,UPI to Friend,Transfer,-997,-4621520,Debit
2024-10-10,Electricity Bill,Utilities,-234,-4621754,Debit
2025-04-22,Internet Recharge,Utilities,-1287,-4623041,Debit
2024-12-29,Cash Deposit,Cash,-8020,-4631061,Debit
2025-04-22,Doctor Visit,Health,-3142,-4634203,Debit
2024-11-12,Received from Rahul,Transfer,-220,-4634423,Debit
2024-09-19,ATM Withdrawal,Cash,-9336,-4643759,Debit
2024-02-07,Medical Store,Health,-8825,-4652584,Debit
2024-07-06,Cash Deposit,Cash,-971,-4653555,Debit
2024-02-27,Uber Ride,Transport,-442,-4653997,Debit
2025-03-28,Internet Recharge,Utilities,-4889,-4658886,Debit
2024-05-10,Interest Credit,Savings Interest,8354,-4650532,Credit
2025-04-14,Spotify,Entertainment,-9272,-4659804,Debit
2025-05-14,Water Bill,Utilities,-2360,-4662164,Debit
2024-10-24,Doctor Visit,Health,-6841,-4669005,Debit
2024-03-26,Flipkart Order,Shopping,-6510,-4675515,Debit
2024-02-04,Train Ticket,Transport,-2094,-4677609,Debit
2024-06-06,Interest Credit,Savings Interest,25894,-4651715,Credit
2024-02-04,Uber Ride,Transport,-4061,-4655776,Debit
2024-11-07,Electronics,Shopping,-290,-4656066,Debit
2024-06-26,Salary Credit,Income,17552,-4638514,Credit
2024-06-26,Interest Credit,Savings Interest,1721,-4636793,Credit
2025-02-17,Movie Tickets,Entertainment,-5826,-4642619,Debit
2024-06-23,FD Interest,Savings Interest,1272,-4641347,Credit
2025-03-02,Amazon Purchase,Shopping,-4587,-4645934,Debit
2025-04-03,ATM Withdrawal,Cash,-2354,-4648288,Debit
2025-01-03,Interest Credit,Savings Interest,25697,-4622591,Credit
2025-01-19,Restaurant Bill,Food,-5566,-4628157,Debit
2025-05-07,Medical Store,Health,-6047,-4634204,Debit
2024-08-11,Spotify,Entertainment,-7656,-4641860,Debit
2024-07-21,Swiggy,Food,-6745,-4648605,Debit
2024-03-20,Medical Store,Health,-5925,-4654530,Debit
2024-02-20,Interest Credit,Savings Interest,26806,-4627724,Credit
2024-02-17,Electronics,Shopping,-7908,-4635632,Debit
2025-04-15,Bank Transfer,Transfer,-103,-4635735,Debit
2025-03-20,Petrol,Transport,-7024,-4642759,Debit
2024-11-21,FD Interest,Savings Interest,24738,-4618021,Credit
2025-04-03,Medical Store,Health,-7612,-4625633,Debit
2024-02-29,FD Interest,Savings Interest,29696,-4595937,Credit
2024-02-02,Received from Rahul,Transfer,-4613,-4600550,Debit
2024-05-27,Swiggy,Food,-9458,-4610008,Debit
2024-12-04,Refund,Income,17676,-4592332,Credit
2025-05-07,Received from Rahul,Transfer,-4999,-4597331,Debit
2025-02-08,FD Interest,Savings Interest,8758,-4588573,Credit
2024-10-31,Medical Store,Health,-9532,-4598105,Debit
2024-03-05,Medical Store,Health,-8065,-4606170,Debit
2024-02-26,Salary Credit,Income,8093,-4598077,Credit
2024-08-29,Received from Rahul,Transfer,-1191,-4599268,Debit
2024-04-15,Bonus,Income,11233,-4588035,Credit
2024-05-21,UPI to Friend,Transfer,-4386,-4592421,Debit
2025-02-21,Interest Credit,Savings Interest,16891,-4575530,Credit
2024-11-25,Swiggy,Food,-6369,-4581899,Debit
2024-01-05,Electricity Bill,Utilities,-8444,-4590343,Debit
2024-05-22,Petrol,Transport,-4319,-4594662,Debit
2024-02-11,Doctor Visit,Health,-6255,-4600917,Debit
2024-07-26,Cash Deposit,Cash,-6362,-4607279,Debit
2024-04-23,Interest Credit,Savings Interest,18535,-4588744,Credit
2024-11-19,FD Interest,Savings Interest,11768,-4576976,Credit
2025-04-13,Medical Store,Health,-2945,-4579921,Debit
2025-01-08,UPI to Friend,Transfer,-6199,-4586120,Debit
2024-04-24,Internet Recharge,Utilities,-4459,-4590579,Debit
2024-08-31,Salary Credit,Income,18182,-4572397,Credit
2024-07-08,Train Ticket,Transport,-3910,-4576307,Debit
2025-03-08,Medical Store,Health,-7329,-4583636,Debit
2025-03-24,Restaurant Bill,Food,-2298,-4585934,Debit
2025-03-14,Bank Transfer,Transfer,-8019,-4593953,Debit
2025-03-10,Spotify,Entertainment,-952,-4594905,Debit
2024-07-13,Medical Store,Health,-7743,-4602648,Debit
2024-09-19,Movie Tickets,Entertainment,-1391,-4604039,Debit
2025-04-07,Zomato Order,Food,-1548,-4605587,Debit
2024-12-10,Train Ticket,Transport,-1723,-4607310,Debit
2024-01-31,FD Interest,Savings Interest,16015,-4591295,Credit
2025-02-01,Amazon Purchase,Shopping,-3399,-4594694,Debit
2024-01-17,Doctor Visit,Health,-5851,-4600545,Debit
2024-06-28,Petrol,Transport,-3150,-4603695,Debit
2025-03-23,Salary Credit,Income,29232,-4574463,Credit
2024-02-08,Cafe Coffee Day,Food,-9947,-4584410,Debit
2024-04-18,Bank Transfer,Transfer,-1807,-4586217,Debit
2024-11-18,Petrol,Transport,-5119,-4591336,Debit
2025-02-07,Uber Ride,Transport,-3432,-4594768,Debit
2024-11-27,Spotify,Entertainment,-9782,-4604550,Debit
2024-10-14,Train Ticket,Transport,-5638,-4610188,Debit
2024-05-04,Electronics,Shopping,-2168,-4612356,Debit
2024-05-06,Freelance Payment,Income,16733,-4595623,Credit
2024-05-11,ATM Withdrawal,Cash,-6528,-4602151,Debit
2024-04-23,Electricity Bill,Utilities,-5953,-4608104,Debit
2024-08-07,Movie Tickets,Entertainment,-7299,-4615403,Debit
2024-01-02,FD Interest,Savings Interest,12046,-4603357,Credit
2024-01-13,Restaurant Bill,Food,-8959,-4612316,Debit
2024-01-06,YouTube Premium,Entertainment,-258,-4612574,Debit
2024-06-30,Cafe Coffee Day,Food,-2208,-4614782,Debit
2024-07-24,YouTube Premium,Entertainment,-9725,-4624507,Debit
2024-03-13,Medical Store,Health,-3265,-4627772,Debit
2024-03-01,Bonus,Income,17100,-4610672,Credit
2025-02-05,Movie Tickets,Entertainment,-3761,-4614433,Debit
2025-03-12,Cash Deposit,Cash,-4645,-4619078,Debit
2024-04-03,Water Bill,Utilities,-6423,-4625501,Debit
2024-01-13,Water Bill,Utilities,-2891,-4628392,Debit
2024-03-04,Electricity Bill,Utilities,-2931,-4631323,Debit
2024-04-12,Petrol,Transport,-2128,-4633451,Debit
2025-02-08,Water Bill,Utilities,-8005,-4641456,Debit
2024-01-31,Electricity Bill,Utilities,-341,-4641797,Debit
2024-06-12,Cafe Coffee Day,Food,-4962,-4646759,Debit
2025-05-10,Amazon Purchase,Shopping,-6837,-4653596,Debit
2024-11-18,Bonus,Income,24444,-4629152,Credit
2024-09-21,Freelance Payment,Income,17335,-4611817,Credit
2024-01-15,ATM Withdrawal,Cash,-190,-4612007,Debit
2025-05-06,Flipkart Order,Shopping,-4304,-4616311,Debit
2024-08-03,Salary Credit,Income,26632,-4589679,Credit
2024-03-03,Spotify,Entertainment,-6544,-4596223,Debit
2025-03-25,UPI to Friend,Transfer,-7302,-4603525,Debit
2024-12-26,Amazon Purchase,Shopping,-3919,-4607444,Debit
2024-02-15,Spotify,Entertainment,-5955,-4613399,Debit
2024-09-18,Electricity Bill,Utilities,-1096,-4614495,Debit
2024-02-02,Interest Credit,Savings Interest,8953,-4605542,Credit
2024-07-19,Cash Deposit,Cash,-3512,-4609054,Debit
2025-01-31,FD Interest,Savings Interest,7353,-4601701,Credit
2025-03-01,Water Bill,Utilities,-8501,-4610202,Debit
2024-10-16,Swiggy,Food,-2523,-4612725,Debit
2025-02-08,Spotify,Entertainment,-7195,-4619920,Debit
2025-01-27,Bank Transfer,Transfer,-8055,-4627975,Debit
2024-06-05,Salary Credit,Income,2277,-4625698,Credit
2024-01-26,Zomato Order,Food,-6103,-4631801,Debit
2024-09-03,Water Bill,Utilities,-7210,-4639011,Debit
2024-07-12,Refund,Income,15582,-4623429,Credit
2025-02-13,FD Interest,Savings Interest,2240,-4621189,Credit
2024-09-03,Cash Deposit,Cash,-8338,-4629527,Debit
2024-06-25,Restaurant Bill,Food,-7457,-4636984,Debit
2024-06-16,Movie Tickets,Entertainment,-4570,-4641554,Debit
2025-02-16,FD Interest,Savings Interest,13097,-4628457,Credit
2024-07-27,Freelance Payment,Income,14210,-4614247,Credit
2024-01-17,Internet Recharge,Utilities,-8072,-4622319,Debit
2025-02-13,Medical Store,Health,-8666,-4630985,Debit
2024-04-19,Petrol,Transport,-3229,-4634214,Debit
2024-12-31,Electricity Bill,Utilities,-5809,-4640023,Debit
2024-02-09,Refund,Income,4031,-4635992,Credit
2024-08-18,FD Interest,Savings Interest,18557,-4617435,Credit
2024-08-02,Myntra Shopping,Shopping,-2782,-4620217,Debit
2025-01-15,Bank Transfer,Transfer,-3577,-4623794,Debit
2024-10-21,Uber Ride,Transport,-7561,-4631355,Debit
2024-02-16,Doctor Visit,Health,-4530,-4635885,Debit
2024-01-28,UPI to Friend,Transfer,-2198,-4638083,Debit
2024-09-07,Interest Credit,Savings Interest,19287,-4618796,Credit
2024-06-11,Interest Credit,Savings Interest,20578,-4598218,Credit
2024-02-07,UPI to Friend,Transfer,-6981,-4605199,Debit
2025-05-07,Uber Ride,Transport,-4310,-4609509,Debit
2024-02-27,Flipkart Order,Shopping,-3765,-4613274,Debit
2024-07-06,Salary Credit,Income,16465,-4596809,Credit
2024-09-02,FD Interest,Savings Interest,28753,-4568056,Credit
2024-04-03,Bank Transfer,Transfer,-6744,-4574800,Debit
2025-03-07,ATM Withdrawal,Cash,-5156,-4579956,Debit
2024-02-08,Cash Deposit,Cash,-6664,-4586620,Debit
2024-01-23,Interest Credit,Savings Interest,28425,-4558195,Credit
2025-01-10,Doctor Visit,Health,-2423,-4560618,Debit
2025-02-24,Flipkart Order,Shopping,-4122,-4564740,Debit
2024-01-06,Movie Tickets,Entertainment,-7686,-4572426,Debit
2024-01-16,FD Interest,Savings Interest,22363,-4550063,Credit
2024-05-11,Myntra Shopping,Shopping,-9021,-4559084,Debit
2025-03-07,Train Ticket,Transport,-4223,-4563307,Debit
2024-03-19,FD Interest,Savings Interest,26358,-4536949,Credit
2024-10-06,Medical Store,Health,-5584,-4542533,Debit
2024-03-28,Train Ticket,Transport,-6493,-4549026,Debit
2024-06-27,Movie Tickets,Entertainment,-3917,-4552943,Debit
2024-01-03,Bonus,Income,3658,-4549285,Credit
2024-06-02,Spotify,Entertainment,-6525,-4555810,Debit
2025-01-29,Amazon Purchase,Shopping,-5789,-4561599,Debit
2025-01-24,Refund,Income,9440,-4552159,Credit
2024-10-10,Restaurant Bill,Food,-2337,-4554496,Debit
2025-03-21,ATM Withdrawal,Cash,-7901,-4562397,Debit
2025-02-09,YouTube Premium,Entertainment,-2536,-4564933,Debit
2025-03-23,Internet Recharge,Utilities,-4572,-4569505,Debit
2024-11-14,Interest Credit,Savings Interest,17763,-4551742,Credit
2025-04-20,Petrol,Transport,-3640,-4555382,Debit
2025-05-12,Freelance Payment,Income,12941,-4542441,Credit
2025-04-18,ATM Withdrawal,Cash,-8169,-4550610,Debit
2024-07-21,Electronics,Shopping,-6073,-4556683,Debit
2024-03-28,Cash Deposit,Cash,-6293,-4562976,Debit
2024-07-12,Swiggy,Food,-3273,-4566249,Debit
2024-03-14,Internet Recharge,Utilities,-9465,-4575714,Debit
2024-12-02,FD Interest,Savings Interest,7200,-4568514,Credit
2025-04-15,FD Interest,Savings Interest,8612,-4559902,Credit
2025-04-23,FD Interest,Savings Interest,6543,-4553359,Credit
2024-11-02,Salary Credit,Income,16956,-4536403,Credit
2024-01-09,Amazon Purchase,Shopping,-5199,-4541602,Debit
2024-09-23,FD Interest,Savings Interest,11339,-4530263,Credit
2024-03-19,Cash Deposit,Cash,-7011,-4537274,Debit
2025-03-02,Received from Rahul,Transfer,-2503,-4539777,Debit
2024-05-12,Interest Credit,Savings Interest,1743,-4538034,Credit
2024-04-25,Electricity Bill,Utilities,-9249,-4547283,Debit
2024-07-08,Refund,Income,10768,-4536515,Credit
2024-11-06,Bonus,Income,18640,-4517875,Credit
2024-09-20,Water Bill,Utilities,-2190,-4520065,Debit
2025-02-06,Cash Deposit,Cash,-7109,-4527174,Debit
2024-12-26,Swiggy,Food,-9535,-4536709,Debit
2025-05-03,Interest Credit,Savings Interest,23579,-4513130,Credit
2024-04-15,FD Interest,Savings Interest,17338,-4495792,Credit
2024-07-08,Bank Transfer,Transfer,-9388,-4505180,Debit
2024-10-16,Interest Credit,Savings Interest,7942,-4497238,Credit
2024-08-07,Swiggy,Food,-7147,-4504385,Debit
2024-08-17,Spotify,Entertainment,-8475,-4512860,Debit
2024-10-30,Electronics,Shopping,-2746,-4515606,Debit
2024-04-13,Bank Transfer,Transfer,-2650,-4518256,Debit
2024-04-06,Flipkart Order,Shopping,-4811,-4523067,Debit
2024-08-19,Spotify,Entertainment,-4851,-4527918,Debit
2025-03-25,Restaurant Bill,Food,-4715,-4532633,Debit
2025-02-05,Freelance Payment,Income,6484,-4526149,Credit
2024-12-21,Flipkart Order,Shopping,-8431,-4534580,Debit
2024-05-23,Water Bill,Utilities,-8285,-4542865,Debit
2024-03-04,Medical Store,Health,-5014,-4547879,Debit
2025-02-23,Swiggy,Food,-9505,-4557384,Debit
2024-01-02,Doctor Visit,Health,-9344,-4566728,Debit
2024-04-23,Restaurant Bill,Food,-5657,-4572385,Debit
2025-05-04,Electronics,Shopping,-2599,-4574984,Debit
2024-07-11,Interest Credit,Savings Interest,23851,-4551133,Credit
2024-04-05,Cash Deposit,Cash,-565,-4551698,Debit
2024-05-11,Restaurant Bill,Food,-2196,-4553894,Debit
2024-12-02,Bonus,Income,27201,-4526693,Credit
2025-04-05,Cash Deposit,Cash,-3349,-4530042,Debit
2024-02-26,Uber Ride,Transport,-998,-4531040,Debit
2024-04-30,Petrol,Transport,-2198,-4533238,Debit
2024-07-02,Petrol,Transport,-4234,-4537472,Debit
2024-11-13,Petrol,Transport,-5204,-4542676,Debit
2024-04-07,Doctor Visit,Health,-9781,-4552457,Debit
2024-02-17,Bank Transfer,Transfer,-7119,-4559576,Debit
2025-04-21,Flipkart Order,Shopping,-5321,-4564897,Debit
2024-12-18,UPI to Friend,Transfer,-852,-4565749,Debit
2024-03-07,Electronics,Shopping,-3194,-4568943,Debit
2024-04-14,Uber Ride,Transport,-3907,-4572850,Debit
2024-03-12,Salary Credit,Income,29371,-4543479,Credit
2025-02-08,Medical Store,Health,-1491,-4544970,Debit
2024-08-29,Medical Store,Health,-7643,-4552613,Debit
2025-02-22,Freelance Payment,Income,24357,-4528256,Credit
2024-07-26,Medical Store,Health,-6769,-4535025,Debit
2024-03-17,Doctor Visit,Health,-1702,-4536727,Debit
2024-08-25,Amazon Purchase,Shopping,-9808,-4546535,Debit
2024-04-26,Movie Tickets,Entertainment,-1801,-4548336,Debit
2024-12-07,Uber Ride,Transport,-5376,-4553712,Debit
2025-03-01,Spotify,Entertainment,-5435,-4559147,Debit
2024-09-22,Movie Tickets,Entertainment,-2685,-4561832,Debit
2024-06-10,Myntra Shopping,Shopping,-9671,-4571503,Debit
2024-01-31,Salary Credit,Income,12804,-4558699,Credit
2024-07-12,FD Interest,Savings Interest,25280,-4533419,Credit
2025-01-22,FD Interest,Savings Interest,18618,-4514801,Credit
2024-12-23,UPI to Friend,Transfer,-5071,-4519872,Debit
2024-06-04,Myntra Shopping,Shopping,-5364,-4525236,Debit
2024-11-14,Spotify,Entertainment,-8022,-4533258,Debit
2024-01-13,Received from Rahul,Transfer,-5558,-4538816,Debit
2024-12-01,Electricity Bill,Utilities,-6154,-4544970,Debit
2024-11-12,Electricity Bill,Utilities,-3099,-4548069,Debit
2024-04-23,Restaurant Bill,Food,-8789,-4556858,Debit
2024-08-04,Doctor Visit,Health,-2120,-4558978,Debit
2025-03-31,ATM Withdrawal,Cash,-3994,-4562972,Debit
2024-07-21,Water Bill,Utilities,-4967,-4567939,Debit
2024-01-03,Internet Recharge,Utilities,-8830,-4576769,Debit
2024-04-26,Zomato Order,Food,-4373,-4581142,Debit
2024-04-03,ATM Withdrawal,Cash,-2109,-4583251,Debit
2024-07-08,Cafe Coffee Day,Food,-2552,-4585803,Debit
2024-09-01,Spotify,Entertainment,-3876,-4589679,Debit
2024-07-17,Amazon Purchase,Shopping,-8464,-4598143,Debit
2024-05-09,Medical Store,Health,-2474,-4600617,Debit
2024-09-09,Refund,Income,28832,-4571785,Credit
2024-10-01,Movie Tickets,Entertainment,-9882,-4581667,Debit
2024-01-09,Movie Tickets,Entertainment,-3043,-4584710,Debit
2024-06-04,Flipkart Order,Shopping,-9389,-4594099,Debit
2024-08-04,Spotify,Entertainment,-2746,-4596845,Debit
2024-05-18,Cafe Coffee Day,Food,-5298,-4602143,Debit
2024-02-29,Water Bill,Utilities,-6218,-4608361,Debit
2024-05-08,Train Ticket,Transport,-3820,-4612181,Debit
2024-11-09,Petrol,Transport,-1453,-4613634,Debit
2025-02-03,Interest Credit,Savings Interest,2799,-4610835,Credit
2025-02-06,UPI to Friend,Transfer,-4419,-4615254,Debit
2025-04-19,FD Interest,Savings Interest,4133,-4611121,Credit
2025-01-29,Movie Tickets,Entertainment,-8954,-4620075,Debit
2025-01-10,YouTube Premium,Entertainment,-9404,-4629479,Debit
2024-07-23,Bank Transfer,Transfer,-7488,-4636967,Debit
2024-12-23,Uber Ride,Transport,-6422,-4643389,Debit
2024-05-07,Doctor Visit,Health,-6504,-4649893,Debit
2024-06-16,Cash Deposit,Cash,-2953,-4652846,Debit
2024-09-07,Freelance Payment,Income,27155,-4625691,Credit
2024-03-28,ATM Withdrawal,Cash,-6736,-4632427,Debit
2024-07-28,Doctor Visit,Health,-5214,-4637641,Debit
2025-03-08,Bank Transfer,Transfer,-3599,-4641240,Debit
2024-05-07,Restaurant Bill,Food,-7430,-4648670,Debit
2024-07-02,Cash Deposit,Cash,-7782,-4656452,Debit
2024-12-08,FD Interest,Savings Interest,17944,-4638508,Credit
2024-10-27,Electronics,Shopping,-2393,-4640901,Debit
2025-02-19,Petrol,Transport,-932,-4641833,Debit
2024-08-09,Amazon Purchase,Shopping,-8222,-4650055,Debit
2024-05-09,Train Ticket,Transport,-8394,-4658449,Debit
2024-08-21,Uber Ride,Transport,-3844,-4662293,Debit
2024-03-19,Swiggy,Food,-514,-4662807,Debit
2024-04-14,Internet Recharge,Utilities,-7899,-4670706,Debit
2024-12-15,ATM Withdrawal,Cash,-7573,-4678279,Debit
2024-04-26,Spotify,Entertainment,-5790,-4684069,Debit
2024-02-23,Bonus,Income,22802,-4661267,Credit
2025-02-10,UPI to Friend,Transfer,-1063,-4662330,Debit
2025-04-13,Salary Credit,Income,6680,-4655650,Credit
2025-04-14,FD Interest,Savings Interest,25409,-4630241,Credit
2025-01-24,Medical Store,Health,-4888,-4635129,Debit
2025-01-18,Zomato Order,Food,-5112,-4640241,Debit
2024-04-21,Uber Ride,Transport,-718,-4640959,Debit
2025-03-16,Flipkart Order,Shopping,-1059,-4642018,Debit
2024-12-04,Electricity Bill,Utilities,-2349,-4644367,Debit
2024-08-01,Salary Credit,Income,12220,-4632147,Credit
2024-12-02,Uber Ride,Transport,-1767,-4633914,Debit
2024-06-15,ATM Withdrawal,Cash,-1565,-4635479,Debit
2024-04-26,Bank Transfer,Transfer,-8348,-4643827,Debit
2024-09-07,UPI to Friend,Transfer,-2383,-4646210,Debit
2024-09-03,Uber Ride,Transport,-2584,-4648794,Debit
2024-06-09,YouTube Premium,Entertainment,-1657,-4650451,Debit
2024-05-02,Electronics,Shopping,-7200,-4657651,Debit
2024-09-26,YouTube Premium,Entertainment,-660,-4658311,Debit
2024-08-11,Internet Recharge,Utilities,-5665,-4663976,Debit
2024-02-22,Water Bill,Utilities,-399,-4664375,Debit
2024-03-15,Swiggy,Food,-6736,-4671111,Debit
2025-01-08,Train Ticket,Transport,-2065,-4673176,Debit
2024-01-12,ATM Withdrawal,Cash,-1381,-4674557,Debit
2024-03-08,Cafe Coffee Day,Food,-2119,-4676676,Debit
2024-03-29,Cash Deposit,Cash,-5730,-4682406,Debit
2024-10-09,Amazon Purchase,Shopping,-9637,-4692043,Debit
2024-12-25,Interest Credit,Savings Interest,3179,-4688864,Credit
2024-07-13,Water Bill,Utilities,-4715,-4693579,Debit
2025-04-25,Received from Rahul,Transfer,-9277,-4702856,Debit
2024-07-03,Medical Store,Health,-5469,-4708325,Debit
2024-09-29,Spotify,Entertainment,-7525,-4715850,Debit
2024-03-31,Train Ticket,Transport,-6482,-4722332,Debit
2024-11-13,Movie Tickets,Entertainment,-5406,-4727738,Debit
2025-02-16,Petrol,Transport,-9830,-4737568,Debit
2024-07-19,Medical Store,Health,-3175,-4740743,Debit
2024-09-30,Amazon Purchase,Shopping,-7096,-4747839,Debit
2024-07-28,Cash Deposit,Cash,-8872,-4756711,Debit
2024-02-02,Train Ticket,Transport,-4622,-4761333,Debit
2024-02-16,Bank Transfer,Transfer,-859,-4762192,Debit
2024-08-28,Bonus,Income,5957,-4756235,Credit
2025-04-10,Water Bill,Utilities,-809,-4757044,Debit
2024-10-07,Bank Transfer,Transfer,-305,-4757349,Debit
2025-04-15,YouTube Premium,Entertainment,-7310,-4764659,Debit
2024-08-05,Uber Ride,Transport,-3233,-4767892,Debit
2025-01-25,ATM Withdrawal,Cash,-7018,-4774910,Debit
2024-04-09,YouTube Premium,Entertainment,-3353,-4778263,Debit
2024-05-31,Spotify,Entertainment,-8077,-4786340,Debit
2024-04-05,FD Interest,Savings Interest,25933,-4760407,Credit
2025-04-19,Cash Deposit,Cash,-4176,-4764583,Debit
2024-01-02,Refund,Income,29211,-4735372,Credit
2024-01-04,Movie Tickets,Entertainment,-712,-4736084,Debit
2024-03-01,Petrol,Transport,-8946,-4745030,Debit
2024-09-02,Freelance Payment,Income,27616,-4717414,Credit
2025-04-14,UPI to Friend,Transfer,-3998,-4721412,Debit
2024-06-21,Zomato Order,Food,-3998,-4725410,Debit
2024-01-21,Refund,Income,703,-4724707,Credit
2024-05-22,Interest Credit,Savings Interest,1448,-4723259,Credit
2024-02-06,Water Bill,Utilities,-8112,-4731371,Debit
2024-01-03,ATM Withdrawal,Cash,-3686,-4735057,Debit
2024-11-26,Amazon Purchase,Shopping,-808,-4735865,Debit
2024-02-07,Zomato Order,Food,-4934,-4740799,Debit
2025-02-11,Bank Transfer,Transfer,-1754,-4742553,Debit
2024-09-15,Salary Credit,Income,25188,-4717365,Credit
2024-08-11,Train Ticket,Transport,-6582,-4723947,Debit
2024-11-24,Salary Credit,Income,14844,-4709103,Credit
2024-04-11,Water Bill,Utilities,-7109,-4716212,Debit
2024-02-03,Interest Credit,Savings Interest,4215,-4711997,Credit
2024-04-02,Water Bill,Utilities,-6294,-4718291,Debit
2024-05-25,Cash Deposit,Cash,-6208,-4724499,Debit
2024-12-20,Cash Deposit,Cash,-9444,-4733943,Debit
2025-02-19,Petrol,Transport,-5139,-4739082,Debit
2025-04-03,Cafe Coffee Day,Food,-1687,-4740769,Debit
2024-06-29,Spotify,Entertainment,-2970,-4743739,Debit
2025-01-26,Myntra Shopping,Shopping,-1348,-4745087,Debit
2025-01-15,Amazon Purchase,Shopping,-9012,-4754099,Debit
2025-04-22,ATM Withdrawal,Cash,-8627,-4762726,Debit
2025-04-03,Electronics,Shopping,-4761,-4767487,Debit
2024-01-18,Water Bill,Utilities,-8690,-4776177,Debit
2025-03-21,Movie Tickets,Entertainment,-7893,-4784070,Debit
2025-03-21,ATM Withdrawal,Cash,-6743,-4790813,Debit
2025-03-27,Doctor Visit,Health,-7402,-4798215,Debit
2024-11-11,Bank Transfer,Transfer,-3049,-4801264,Debit
2024-03-16,Medical Store,Health,-1683,-4802947,Debit
2024-01-28,Uber Ride,Transport,-7103,-4810050,Debit
2024-05-30,Movie Tickets,Entertainment,-4600,-4814650,Debit
2024-02-23,Zomato Order,Food,-747,-4815397,Debit
2025-01-11,Interest Credit,Savings Interest,22786,-4792611,Credit
2024-05-17,Spotify,Entertainment,-208,-4792819,Debit
2025-02-13,Internet Recharge,Utilities,-564,-4793383,Debit
2024-12-07,Spotify,Entertainment,-9952,-4803335,Debit
2024-10-03,Uber Ride,Transport,-5045,-4808380,Debit
2024-11-08,ATM Withdrawal,Cash,-9116,-4817496,Debit
2024-02-16,Uber Ride,Transport,-7385,-4824881,Debit
2024-06-25,Flipkart Order,Shopping,-5175,-4830056,Debit
2025-01-31,Cafe Coffee Day,Food,-7548,-4837604,Debit
2024-10-01,UPI to Friend,Transfer,-9867,-4847471,Debit
2024-11-03,Internet Recharge,Utilities,-6316,-4853787,Debit
2024-07-07,Salary Credit,Income,17392,-4836395,Credit
2024-09-30,Internet Recharge,Utilities,-8988,-4845383,Debit
2025-04-18,Amazon Purchase,Shopping,-1209,-4846592,Debit
2024-07-10,Flipkart Order,Shopping,-2298,-4848890,Debit
2024-09-01,Received from Rahul,Transfer,-632,-4849522,Debit
2024-07-02,UPI to Friend,Transfer,-495,-4850017,Debit
2024-06-23,Cafe Coffee Day,Food,-7116,-4857133,Debit
2024-08-18,Medical Store,Health,-3924,-4861057,Debit
2025-03-12,UPI to Friend,Transfer,-2090,-4863147,Debit
2024-08-07,Interest Credit,Savings Interest,28885,-4834262,Credit
2024-11-24,Water Bill,Utilities,-8557,-4842819,Debit
2024-12-18,Myntra Shopping,Shopping,-3084,-4845903,Debit
2024-03-19,FD Interest,Savings Interest,7870,-4838033,Credit
2024-04-04,Received from Rahul,Transfer,-5337,-4843370,Debit
2024-10-20,Doctor Visit,Health,-1217,-4844587,Debit
2024-11-19,Movie Tickets,Entertainment,-6523,-4851110,Debit
2024-02-23,Spotify,Entertainment,-2828,-4853938,Debit
2024-08-22,YouTube Premium,Entertainment,-7280,-4861218,Debit
2024-09-01,Water Bill,Utilities,-8403,-4869621,Debit
2025-01-08,FD Interest,Savings Interest,20672,-4848949,Credit
2024-07-28,Medical Store,Health,-4002,-4852951,Debit
2024-07-18,Medical Store,Health,-6124,-4859075,Debit
2024-01-12,Cafe Coffee Day,Food,-8423,-4867498,Debit
2025-05-08,Cash Deposit,Cash,-9575,-4877073,Debit
2025-02-21,Electricity Bill,Utilities,-5995,-4883068,Debit
2024-08-28,Petrol,Transport,-5466,-4888534,Debit
2025-01-03,FD Interest,Savings Interest,10782,-4877752,Credit
2025-03-25,ATM Withdrawal,Cash,-5340,-4883092,Debit
2024-07-21,ATM Withdrawal,Cash,-8219,-4891311,Debit
2024-02-26,Movie Tickets,Entertainment,-8888,-4900199,Debit
2024-07-03,Doctor Visit,Health,-8646,-4908845,Debit
2025-04-06,Received from Rahul,Transfer,-8307,-4917152,Debit
2025-03-21,Cafe Coffee Day,Food,-7903,-4925055,Debit
2025-01-24,Train Ticket,Transport,-7196,-4932251,Debit
2024-06-22,Bank Transfer,Transfer,-1096,-4933347,Debit
2024-04-11,Received from Rahul,Transfer,-5533,-4938880,Debit
2024-10-28,Electronics,Shopping,-8628,-4947508,Debit
2025-02-26,Interest Credit,Savings Interest,982,-4946526,Credit
2024-10-11,Medical Store,Health,-9425,-4955951,Debit
2024-03-09,Train Ticket,Transport,-8089,-4964040,Debit
2024-09-05,Train Ticket,Transport,-2014,-4966054,Debit
2024-06-04,UPI to Friend,Transfer,-8676,-4974730,Debit
2025-02-12,Zomato Order,Food,-958,-4975688,Debit
2024-01-21,FD Interest,Savings Interest,27773,-4947915,Credit
2024-11-06,Interest Credit,Savings Interest,21819,-4926096,Credit
2024-05-19,Zomato Order,Food,-1245,-4927341,Debit
2024-07-14,Medical Store,Health,-7237,-4934578,Debit
2024-11-28,Water Bill,Utilities,-5360,-4939938,Debit
2025-01-09,Medical Store,Health,-9211,-4949149,Debit
2024-05-12,YouTube Premium,Entertainment,-4884,-4954033,Debit
2024-06-15,Bank Transfer,Transfer,-7422,-4961455,Debit
2024-07-29,Restaurant Bill,Food,-7108,-4968563,Debit
2024-04-15,Swiggy,Food,-4859,-4973422,Debit
2024-09-22,Myntra Shopping,Shopping,-7831,-4981253,Debit
2024-05-17,Cash Deposit,Cash,-3434,-4984687,Debit
2024-01-01,FD Interest,Savings Interest,17022,-4967665,Credit
2024-04-26,Bonus,Income,4078,-4963587,Credit
2024-06-09,Bonus,Income,20742,-4942845,Credit
2024-05-04,Electricity Bill,Utilities,-5408,-4948253,Debit
2024-09-04,Freelance Payment,Income,23802,-4924451,Credit
2024-11-29,FD Interest,Savings Interest,9226,-4915225,Credit
2024-12-27,Received from Rahul,Transfer,-2631,-4917856,Debit
2024-09-30,Electronics,Shopping,-1312,-4919168,Debit
2024-07-11,Zomato Order,Food,-6174,-4925342,Debit
2025-04-14,UPI to Friend,Transfer,-5435,-4930777,Debit
2024-04-27,Electronics,Shopping,-5231,-4936008,Debit
2024-06-11,Restaurant Bill,Food,-4941,-4940949,Debit
2024-05-22,Bank Transfer,Transfer,-3878,-4944827,Debit
2025-03-24,Received from Rahul,Transfer,-2188,-4947015,Debit
2025-01-21,ATM Withdrawal,Cash,-6326,-4953341,Debit
2024-04-24,Interest Credit,Savings Interest,11462,-4941879,Credit
2024-09-06,Movie Tickets,Entertainment,-3524,-4945403,Debit
2024-06-25,Internet Recharge,Utilities,-9991,-4955394,Debit
2024-02-23,Interest Credit,Savings Interest,20744,-4934650,Credit
2024-11-27,Internet Recharge,Utilities,-1909,-4936559,Debit
2024-05-16,Petrol,Transport,-4667,-4941226,Debit
2025-02-02,UPI to Friend,Transfer,-4980,-4946206,Debit
2024-02-02,Zomato Order,Food,-4812,-4951018,Debit
2025-01-18,Bank Transfer,Transfer,-217,-4951235,Debit
2024-11-22,FD Interest,Savings Interest,9329,-4941906,Credit
2024-09-03,Refund,Income,29930,-4911976,Credit
2025-02-11,Medical Store,Health,-8306,-4920282,Debit
2024-04-21,Doctor Visit,Health,-4646,-4924928,Debit
2025-03-19,Received from Rahul,Transfer,-2430,-4927358,Debit
2025-01-04,Amazon Purchase,Shopping,-7876,-4935234,Debit
2025-05-11,Doctor Visit,Health,-3721,-4938955,Debit
2025-04-25,Doctor Visit,Health,-9797,-4948752,Debit
2024-03-09,Interest Credit,Savings Interest,7333,-4941419,Credit
2024-07-19,Refund,Income,4563,-4936856,Credit
2024-07-07,Myntra Shopping,Shopping,-982,-4937838,Debit
2024-05-12,Zomato Order,Food,-5669,-4943507,Debit
2024-01-10,UPI to Friend,Transfer,-4499,-4948006,Debit
2024-08-13,Movie Tickets,Entertainment,-9376,-4957382,Debit
2024-11-06,Medical Store,Health,-2139,-4959521,Debit
2024-05-24,Water Bill,Utilities,-7553,-4967074,Debit
2024-01-09,Train Ticket,Transport,-4736,-4971810,Debit
2025-05-01,Movie Tickets,Entertainment,-1727,-4973537,Debit
2024-12-21,Internet Recharge,Utilities,-6039,-4979576,Debit
2024-02-17,Medical Store,Health,-1002,-4980578,Debit
2024-09-29,Medical Store,Health,-3352,-4983930,Debit
2024-07-16,Freelance Payment,Income,2551,-4981379,Credit
2024-08-31,Petrol,Transport,-2175,-4983554,Debit
2024-01-07,Movie Tickets,Entertainment,-5656,-4989210,Debit
2024-11-06,UPI to Friend,Transfer,-4136,-4993346,Debit
2024-01-03,Cash Deposit,Cash,-1566,-4994912,Debit
2025-01-25,Cash Deposit,Cash,-5701,-5000613,Debit
2025-04-18,Received from Rahul,Transfer,-5755,-5006368,Debit
2024-09-28,Bank Transfer,Transfer,-1869,-5008237,Debit
2024-05-05,Internet Recharge,Utilities,-4460,-5012697,Debit
2024-07-09,FD Interest,Savings Interest,27818,-4984879,Credit
2024-06-28,Medical Store,Health,-7475,-4992354,Debit
2024-02-18,Train Ticket,Transport,-9251,-5001605,Debit
2024-05-28,Electronics,Shopping,-1751,-5003356,Debit
2024-06-28,Movie Tickets,Entertainment,-4720,-5008076,Debit
2024-10-26,Salary Credit,Income,15841,-4992235,Credit
2025-01-13,FD Interest,Savings Interest,8674,-4983561,Credit
2024-12-10,Spotify,Entertainment,-5097,-4988658,Debit
2025-04-27,FD Interest,Savings Interest,15774,-4972884,Credit
2024-01-31,Movie Tickets,Entertainment,-3465,-4976349,Debit
2024-02-20,Amazon Purchase,Shopping,-8508,-4984857,Debit
2025-04-25,Bonus,Income,19117,-4965740,Credit
2025-01-24,Amazon Purchase,Shopping,-720,-4966460,Debit
2024-10-25,Interest Credit,Savings Interest,5021,-4961439,Credit
2024-04-20,Myntra Shopping,Shopping,-9253,-4970692,Debit
2024-04-22,YouTube Premium,Entertainment,-211,-4970903,Debit
2024-04-02,Water Bill,Utilities,-2782,-4973685,Debit
2024-06-27,Freelance Payment,Income,8849,-4964836,Credit
2024-12-11,Received from Rahul,Transfer,-1082,-4965918,Debit
2025-02-03,ATM Withdrawal,Cash,-6041,-4971959,Debit
2025-02-17,Myntra Shopping,Shopping,-4459,-4976418,Debit
2024-03-03,Restaurant Bill,Food,-1817,-4978235,Debit
2025-01-07,Train Ticket,Transport,-7338,-4985573,Debit
2025-01-25,YouTube Premium,Entertainment,-7864,-4993437,Debit
2024-07-12,Restaurant Bill,Food,-5560,-4998997,Debit
2024-09-20,Received from Rahul,Transfer,-3286,-5002283,Debit
2024-03-01,Train Ticket,Transport,-5998,-5008281,Debit
2024-12-27,Electronics,Shopping,-5510,-5013791,Debit
2024-03-05,Medical Store,Health,-1804,-5015595,Debit
2024-12-27,Zomato Order,Food,-3649,-5019244,Debit
2024-12-04,Bank Transfer,Transfer,-6753,-5025997,Debit
2024-12-23,Zomato Order,Food,-6808,-5032805,Debit
2024-07-17,Zomato Order,Food,-2740,-5035545,Debit
2024-12-15,Amazon Purchase,Shopping,-1472,-5037017,Debit
2024-03-24,Internet Recharge,Utilities,-6324,-5043341,Debit
2025-04-08,Cash Deposit,Cash,-3077,-5046418,Debit
2024-09-25,Bank Transfer,Transfer,-8519,-5054937,Debit
2025-01-17,Zomato Order,Food,-4930,-5059867,Debit
2025-01-24,Internet Recharge,Utilities,-5278,-5065145,Debit
2024-06-19,FD Interest,Savings Interest,14420,-5050725,Credit
2024-01-24,Petrol,Transport,-5988,-5056713,Debit
2024-04-09,Spotify,Entertainment,-7630,-5064343,Debit
2024-08-11,Doctor Visit,Health,-7446,-5071789,Debit
2024-10-16,Swiggy,Food,-6274,-5078063,Debit
2024-03-30,Flipkart Order,Shopping,-397,-5078460,Debit
2024-06-09,Doctor Visit,Health,-8549,-5087009,Debit
2024-09-20,FD Interest,Savings Interest,13382,-5073627,Credit
2024-06-13,Myntra Shopping,Shopping,-7457,-5081084,Debit
2024-05-13,Electronics,Shopping,-6433,-5087517,Debit
2024-01-19,Electronics,Shopping,-5804,-5093321,Debit
2024-08-23,Train Ticket,Transport,-6027,-5099348,Debit
2024-11-09,Interest Credit,Savings Interest,24308,-5075040,Credit
2025-03-06,Received from Rahul,Transfer,-4719,-5079759,Debit
2025-03-21,Cafe Coffee Day,Food,-1027,-5080786,Debit
2024-04-16,ATM Withdrawal,Cash,-7848,-5088634,Debit
2025-01-25,Electronics,Shopping,-8814,-5097448,Debit
2024-11-12,UPI to Friend,Transfer,-3100,-5100548,Debit
2024-01-31,Spotify,Entertainment,-9836,-5110384,Debit
2024-08-20,Water Bill,Utilities,-7904,-5118288,Debit
2024-05-26,Swiggy,Food,-2172,-5120460,Debit
2025-01-21,Flipkart Order,Shopping,-8444,-5128904,Debit
2025-04-06,Doctor Visit,Health,-1191,-5130095,Debit
2025-01-12,Internet Recharge,Utilities,-8911,-5139006,Debit
2024-09-05,Cash Deposit,Cash,-6797,-5145803,Debit
2024-11-20,Interest Credit,Savings Interest,11643,-5134160,Credit
2024-12-01,Electricity Bill,Utilities,-6335,-5140495,Debit
2025-03-02,Freelance Payment,Income,19842,-5120653,Credit
2024-10-27,Medical Store,Health,-9807,-5130460,Debit
2024-12-27,Train Ticket,Transport,-4976,-5135436,Debit
2024-12-17,Bonus,Income,29935,-5105501,Credit
2025-01-14,ATM Withdrawal,Cash,-4096,-5109597,Debit
2025-01-20,Amazon Purchase,Shopping,-100,-5109697,Debit
2024-04-08,UPI to Friend,Transfer,-129,-5109826,Debit
2024-02-10,Freelance Payment,Income,18918,-5090908,Credit
2024-07-07,Internet Recharge,Utilities,-8381,-5099289,Debit
2024-08-11,Swiggy,Food,-418,-5099707,Debit
2025-02-24,FD Interest,Savings Interest,24340,-5075367,Credit
2024-02-17,YouTube Premium,Entertainment,-3501,-5078868,Debit
2024-01-29,Uber Ride,Transport,-7377,-5086245,Debit
2024-09-02,Cash Deposit,Cash,-5921,-5092166,Debit
2024-03-21,Electronics,Shopping,-1924,-5094090,Debit
2025-03-31,Salary Credit,Income,19198,-5074892,Credit
2024-01-23,Movie Tickets,Entertainment,-1229,-5076121,Debit
2024-09-14,Doctor Visit,Health,-1339,-5077460,Debit
2025-02-09,Medical Store,Health,-3280,-5080740,Debit
2024-12-13,Doctor Visit,Health,-3971,-5084711,Debit
2025-01-16,Received from Rahul,Transfer,-7551,-5092262,Debit
2024-03-18,Medical Store,Health,-5414,-5097676,Debit
2024-06-16,UPI to Friend,Transfer,-3539,-5101215,Debit
2024-05-18,Interest Credit,Savings Interest,13046,-5088169,Credit
2024-02-16,FD Interest,Savings Interest,26986,-5061183,Credit
2025-04-12,Myntra Shopping,Shopping,-5096,-5066279,Debit
2024-07-17,Petrol,Transport,-7577,-5073856,Debit
2024-12-04,Movie Tickets,Entertainment,-1985,-5075841,Debit
2024-03-01,Movie Tickets,Entertainment,-4063,-5079904,Debit
2025-04-01,Electricity Bill,Utilities,-9143,-5089047,Debit
2024-04-07,Interest Credit,Savings Interest,22153,-5066894,Credit
2024-04-09,Restaurant Bill,Food,-1958,-5068852,Debit
2024-07-10,Restaurant Bill,Food,-2279,-5071131,Debit
2025-03-01,Water Bill,Utilities,-5660,-5076791,Debit
2024-11-10,Doctor Visit,Health,-2243,-5079034,Debit
2024-12-22,Train Ticket,Transport,-237,-5079271,Debit
2024-11-01,Zomato Order,Food,-7638,-5086909,Debit
2024-09-18,Freelance Payment,Income,1395,-5085514,Credit
2024-11-25,Electricity Bill,Utilities,-6798,-5092312,Debit
2024-11-19,Flipkart Order,Shopping,-1110,-5093422,Debit
2024-06-18,Interest Credit,Savings Interest,16885,-5076537,Credit
2025-01-19,Petrol,Transport,-9521,-5086058,Debit
2024-03-18,Salary Credit,Income,8081,-5077977,Credit
2025-01-19,Electricity Bill,Utilities,-5380,-5083357,Debit
2024-09-07,Bonus,Income,24543,-5058814,Credit
2024-08-18,Myntra Shopping,Shopping,-7964,-5066778,Debit
2024-06-30,Salary Credit,Income,15710,-5051068,Credit
2024-07-09,Bank Transfer,Transfer,-152,-5051220,Debit
2024-05-03,Flipkart Order,Shopping,-9775,-5060995,Debit
2024-03-28,Received from Rahul,Transfer,-3595,-5064590,Debit
2024-06-26,Electricity Bill,Utilities,-8937,-5073527,Debit
2024-12-25,Uber Ride,Transport,-2060,-5075587,Debit
2025-01-11,Bank Transfer,Transfer,-9001,-5084588,Debit
2024-06-23,Amazon Purchase,Shopping,-6532,-5091120,Debit
2025-02-07,Medical Store,Health,-3354,-5094474,Debit
2024-10-14,Petrol,Transport,-7015,-5101489,Debit
2025-04-19,Uber Ride,Transport,-5391,-5106880,Debit
2024-12-11,Interest Credit,Savings Interest,521,-5106359,Credit
2024-08-09,Uber Ride,Transport,-3434,-5109793,Debit
2024-06-25,Interest Credit,Savings Interest,25596,-5084197,Credit
2024-11-26,Interest Credit,Savings Interest,21416,-5062781,Credit
2024-10-11,ATM Withdrawal,Cash,-7842,-5070623,Debit
2024-12-24,Spotify,Entertainment,-7520,-5078143,Debit
2024-08-20,Doctor Visit,Health,-9874,-5088017,Debit
2024-06-26,Cafe Coffee Day,Food,-393,-5088410,Debit
2024-07-05,Spotify,Entertainment,-7057,-5095467,Debit
2024-07-12,Received from Rahul,Transfer,-5351,-5100818,Debit
2024-04-25,ATM Withdrawal,Cash,-1747,-5102565,Debit
2024-02-16,FD Interest,Savings Interest,9746,-5092819,Credit
2024-01-14,Flipkart Order,Shopping,-7068,-5099887,Debit
2024-05-09,Cash Deposit,Cash,-1344,-5101231,Debit
2024-06-18,Cash Deposit,Cash,-9138,-5110369,Debit
2025-05-03,Interest Credit,Savings Interest,2942,-5107427,Credit
2024-05-09,Freelance Payment,Income,14547,-5092880,Credit
2024-04-26,Interest Credit,Savings Interest,26609,-5066271,Credit
2024-03-04,Restaurant Bill,Food,-6538,-5072809,Debit
2024-04-14,Medical Store,Health,-7610,-5080419,Debit
2024-09-02,Zomato Order,Food,-1954,-5082373,Debit
2024-12-28,UPI to Friend,Transfer,-6529,-5088902,Debit
2025-03-03,Received from Rahul,Transfer,-3443,-5092345,Debit
2024-09-16,Swiggy,Food,-2506,-5094851,Debit
2024-07-09,Cafe Coffee Day,Food,-9443,-5104294,Debit
2024-04-04,Cash Deposit,Cash,-5432,-5109726,Debit
2024-01-05,Cash Deposit,Cash,-385,-5110111,Debit
2024-05-20,ATM Withdrawal,Cash,-682,-5110793,Debit
2024-02-13,Petrol,Transport,-3734,-5114527,Debit
2024-04-03,Cash Deposit,Cash,-4056,-5118583,Debit
2024-06-14,Uber Ride,Transport,-8014,-5126597,Debit
2025-04-06,Cash Deposit,Cash,-9728,-5136325,Debit
2025-01-09,Amazon Purchase,Shopping,-7926,-5144251,Debit
2025-01-25,Movie Tickets,Entertainment,-9983,-5154234,Debit
2025-02-13,Refund,Income,21242,-5132992,Credit
2025-05-03,Train Ticket,Transport,-4442,-5137434,Debit
2024-05-08,Flipkart Order,Shopping,-2813,-5140247,Debit
2024-06-29,Zomato Order,Food,-1287,-5141534,Debit
2025-03-01,FD Interest,Savings Interest,15012,-5126522,Credit
2025-01-29,ATM Withdrawal,Cash,-7781,-5134303,Debit
2025-03-01,FD Interest,Savings Interest,11049,-5123254,Credit
2024-03-25,Cafe Coffee Day,Food,-5256,-5128510,Debit
2024-11-01,Interest Credit,Savings Interest,14424,-5114086,Credit
2024-02-20,Received from Rahul,Transfer,-6742,-5120828,Debit
2025-05-09,Doctor Visit,Health,-3222,-5124050,Debit
2024-11-21,YouTube Premium,Entertainment,-4862,-5128912,Debit
2024-02-11,Spotify,Entertainment,-7184,-5136096,Debit
2024-09-18,Medical Store,Health,-491,-5136587,Debit
2025-04-13,Bonus,Income,27162,-5109425,Credit
2025-03-29,Freelance Payment,Income,26253,-5083172,Credit
2024-01-26,Movie Tickets,Entertainment,-4817,-5087989,Debit
2024-06-23,Cash Deposit,Cash,-1140,-5089129,Debit
2025-02-07,Petrol,Transport,-4021,-5093150,Debit
2024-07-26,Bank Transfer,Transfer,-4035,-5097185,Debit
2025-03-17,Doctor Visit,Health,-8937,-5106122,Debit
2024-02-25,Electricity Bill,Utilities,-5921,-5112043,Debit
2024-02-23,Received from Rahul,Transfer,-517,-5112560,Debit
2025-03-12,Interest Credit,Savings Interest,11379,-5101181,Credit
2024-09-12,Medical Store,Health,-291,-5101472,Debit
2024-03-23,Spotify,Entertainment,-3372,-5104844,Debit
2025-01-12,UPI to Friend,Transfer,-3565,-5108409,Debit
2024-09-16,Flipkart Order,Shopping,-1754,-5110163,Debit
2025-04-25,Restaurant Bill,Food,-5604,-5115767,Debit
2025-03-18,Petrol,Transport,-7107,-5122874,Debit
2024-11-11,ATM Withdrawal,Cash,-152,-5123026,Debit
2024-04-29,Myntra Shopping,Shopping,-6324,-5129350,Debit
2024-05-16,Spotify,Entertainment,-8888,-5138238,Debit
2024-11-10,Freelance Payment,Income,20201,-5118037,Credit
2024-06-07,Bank Transfer,Transfer,-1497,-5119534,Debit
2024-10-01,YouTube Premium,Entertainment,-7024,-5126558,Debit
2024-03-20,Petrol,Transport,-5861,-5132419,Debit
2025-01-29,Received from Rahul,Transfer,-9225,-5141644,Debit
2025-02-10,Interest Credit,Savings Interest,11704,-5129940,Credit
2025-05-08,Cash Deposit,Cash,-2886,-5132826,Debit
2024-03-19,YouTube Premium,Entertainment,-1866,-5134692,Debit
2024-09-12,Salary Credit,Income,14009,-5120683,Credit
2024-05-22,ATM Withdrawal,Cash,-6218,-5126901,Debit
2025-05-14,Electricity Bill,Utilities,-2954,-5129855,Debit
2024-09-11,FD Interest,Savings Interest,21603,-5108252,Credit
2024-10-02,Internet Recharge,Utilities,-1253,-5109505,Debit
2024-03-28,Zomato Order,Food,-1610,-5111115,Debit
2025-04-27,Electricity Bill,Utilities,-2809,-5113924,Debit
2025-02-10,Uber Ride,Transport,-278,-5114202,Debit
2024-09-26,Electricity Bill,Utilities,-5917,-5120119,Debit
2025-01-24,Uber Ride,Transport,-3735,-5123854,Debit
2025-04-24,Train Ticket,Transport,-8931,-5132785,Debit
2025-03-14,UPI to Friend,Transfer,-201,-5132986,Debit
2025-03-04,Amazon Purchase,Shopping,-2258,-5135244,Debit
2024-06-20,Internet Recharge,Utilities,-9736,-5144980,Debit
2024-09-29,Bonus,Income,11928,-5133052,Credit
2024-10-16,Medical Store,Health,-665,-5133717,Debit
2024-12-25,FD Interest,Savings Interest,3126,-5130591,Credit
2024-05-05,Bonus,Income,3431,-5127160,Credit
2024-11-24,Amazon Purchase,Shopping,-1211,-5128371,Debit
2024-06-30,Uber Ride,Transport,-3449,-5131820,Debit
2025-01-11,Refund,Income,25507,-5106313,Credit
2024-09-24,FD Interest,Savings Interest,22146,-5084167,Credit
2025-02-17,Restaurant Bill,Food,-3630,-5087797,Debit
2024-08-01,Movie Tickets,Entertainment,-4794,-5092591,Debit
2024-02-01,Water Bill,Utilities,-1475,-5094066,Debit
2024-04-04,Uber Ride,Transport,-8776,-5102842,Debit
2024-01-31,ATM Withdrawal,Cash,-6233,-5109075,Debit
2024-07-08,YouTube Premium,Entertainment,-5673,-5114748,Debit
2024-08-22,Amazon Purchase,Shopping,-5357,-5120105,Debit
2024-04-10,Restaurant Bill,Food,-144,-5120249,Debit
2025-01-17,Cafe Coffee Day,Food,-4626,-5124875,Debit
2024-06-03,Zomato Order,Food,-1201,-5126076,Debit
2025-01-15,Medical Store,Health,-5124,-5131200,Debit
2024-07-30,Water Bill,Utilities,-6572,-5137772,Debit
2024-12-29,Flipkart Order,Shopping,-453,-5138225,Debit
2024-09-11,Amazon Purchase,Shopping,-1851,-5140076,Debit
2025-03-18,Interest Credit,Savings Interest,19047,-5121029,Credit
2024-11-14,ATM Withdrawal,Cash,-7017,-5128046,Debit
2025-01-21,Flipkart Order,Shopping,-1665,-5129711,Debit
2024-01-09,Myntra Shopping,Shopping,-5200,-5134911,Debit
2024-11-13,Amazon Purchase,Shopping,-357,-5135268,Debit
2024-09-04,Restaurant Bill,Food,-7280,-5142548,Debit
2025-01-01,Internet Recharge,Utilities,-7037,-5149585,Debit
2024-06-11,Cafe Coffee Day,Food,-6224,-5155809,Debit
2024-09-20,ATM Withdrawal,Cash,-3194,-5159003,Debit
2025-04-07,Salary Credit,Income,24851,-5134152,Credit
2024-04-01,Zomato Order,Food,-6190,-5140342,Debit
2025-01-21,Train Ticket,Transport,-4544,-5144886,Debit
2024-07-04,Doctor Visit,Health,-1604,-5146490,Debit
2025-05-10,Cafe Coffee Day,Food,-351,-5146841,Debit
2024-07-17,Freelance Payment,Income,5530,-5141311,Credit
2024-02-02,Uber Ride,Transport,-7075,-5148386,Debit
2024-06-24,ATM Withdrawal,Cash,-4297,-5152683,Debit
2024-06-20,Petrol,Transport,-3126,-5155809,Debit
2024-05-09,Interest Credit,Savings Interest,12508,-5143301,Credit
2024-05-01,Bonus,Income,22736,-5120565,Credit
2025-02-09,Swiggy,Food,-9784,-5130349,Debit
2024-04-22,YouTube Premium,Entertainment,-5954,-5136303,Debit
2024-11-02,Movie Tickets,Entertainment,-1978,-5138281,Debit
2025-04-24,UPI to Friend,Transfer,-4229,-5142510,Debit
2024-04-19,Internet Recharge,Utilities,-260,-5142770,Debit
2025-02-10,Medical Store,Health,-3420,-5146190,Debit
2025-01-30,UPI to Friend,Transfer,-3968,-5150158,Debit
2024-07-09,Petrol,Transport,-1925,-5152083,Debit
2025-01-11,Flipkart Order,Shopping,-7301,-5159384,Debit
2024-06-15,Received from Rahul,Transfer,-4011,-5163395,Debit
2025-05-05,Electricity Bill,Utilities,-5851,-5169246,Debit
2024-10-12,Medical Store,Health,-4337,-5173583,Debit
2024-04-13,Cafe Coffee Day,Food,-4444,-5178027,Debit
2025-04-12,Myntra Shopping,Shopping,-5724,-5183751,Debit
2025-03-16,UPI to Friend,Transfer,-5884,-5189635,Debit
2024-02-07,YouTube Premium,Entertainment,-3685,-5193320,Debit
2024-08-18,FD Interest,Savings Interest,9295,-5184025,Credit
2025-05-06,UPI to Friend,Transfer,-5967,-5189992,Debit
2024-04-05,FD Interest,Savings Interest,21474,-5168518,Credit
2024-10-17,Medical Store,Health,-6830,-5175348,Debit
2024-09-17,Movie Tickets,Entertainment,-6839,-5182187,Debit
2024-08-24,Cash Deposit,Cash,-2201,-5184388,Debit
2024-11-13,ATM Withdrawal,Cash,-1552,-5185940,Debit
2024-04-21,Movie Tickets,Entertainment,-3201,-5189141,Debit
2024-12-18,YouTube Premium,Entertainment,-4072,-5193213,Debit
2025-02-11,Train Ticket,Transport,-7175,-5200388,Debit
2024-02-27,Bank Transfer,Transfer,-7202,-5207590,Debit
2024-09-16,Uber Ride,Transport,-7672,-5215262,Debit
2025-01-24,Uber Ride,Transport,-9350,-5224612,Debit
2024-11-20,Myntra Shopping,Shopping,-5718,-5230330,Debit
2025-04-26,Doctor Visit,Health,-5516,-5235846,Debit
2024-05-22,Uber Ride,Transport,-3242,-5239088,Debit
2024-01-22,Movie Tickets,Entertainment,-6293,-5245381,Debit
2024-10-28,Doctor Visit,Health,-6237,-5251618,Debit
2024-07-03,Bonus,Income,29142,-5222476,Credit
2024-09-07,Medical Store,Health,-8601,-5231077,Debit
2025-02-05,Doctor Visit,Health,-2863,-5233940,Debit
2025-04-17,Freelance Payment,Income,11224,-5222716,Credit
2024-09-20,ATM Withdrawal,Cash,-853,-5223569,Debit
2024-01-26,Received from Rahul,Transfer,-9433,-5233002,Debit
2025-03-25,Cash Deposit,Cash,-8564,-5241566,Debit
2024-11-21,Received from Rahul,Transfer,-612,-5242178,Debit
2025-05-01,Uber Ride,Transport,-9630,-5251808,Debit
2024-02-17,Cafe Coffee Day,Food,-8585,-5260393,Debit
2024-08-21,Swiggy,Food,-2001,-5262394,Debit
2024-07-14,Train Ticket,Transport,-5170,-5267564,Debit
2024-06-14,Spotify,Entertainment,-5804,-5273368,Debit
2024-05-10,Swiggy,Food,-8856,-5282224,Debit
2025-02-13,Amazon Purchase,Shopping,-3540,-5285764,Debit
2024-10-19,UPI to Friend,Transfer,-1482,-5287246,Debit
2025-04-11,Doctor Visit,Health,-1646,-5288892,Debit
2025-01-17,ATM Withdrawal,Cash,-1902,-5290794,Debit
2024-03-25,Doctor Visit,Health,-8640,-5299434,Debit
2024-11-07,Internet Recharge,Utilities,-9700,-5309134,Debit
2025-05-01,Uber Ride,Transport,-9199,-5318333,Debit
2025-02-13,Water Bill,Utilities,-4988,-5323321,Debit
2024-07-10,Cash Deposit,Cash,-4579,-5327900,Debit
2024-11-27,Bonus,Income,1738,-5326162,Credit
2024-06-25,Cash Deposit,Cash,-1614,-5327776,Debit
2024-02-12,Internet Recharge,Utilities,-8113,-5335889,Debit
2024-03-18,Cafe Coffee Day,Food,-6196,-5342085,Debit
2024-12-05,Spotify,Entertainment,-4515,-5346600,Debit
2024-02-06,Uber Ride,Transport,-3791,-5350391,Debit
2024-03-08,Flipkart Order,Shopping,-9101,-5359492,Debit
2024-03-12,Medical Store,Health,-8550,-5368042,Debit
2024-08-03,Doctor Visit,Health,-5132,-5373174,Debit
2024-08-12,Amazon Purchase,Shopping,-8774,-5381948,Debit
2024-11-19,Bank Transfer,Transfer,-5574,-5387522,Debit
2024-12-12,Train Ticket,Transport,-9303,-5396825,Debit
2025-02-14,Interest Credit,Savings Interest,21220,-5375605,Credit
2024-07-07,Medical Store,Health,-2785,-5378390,Debit
2024-04-05,Bonus,Income,4127,-5374263,Credit
2024-04-03,Restaurant Bill,Food,-9156,-5383419,Debit
2024-12-26,Electricity Bill,Utilities,-5998,-5389417,Debit
2024-08-20,Petrol,Transport,-4376,-5393793,Debit
2024-11-09,Electricity Bill,Utilities,-1436,-5395229,Debit
2024-03-13,Salary Credit,Income,19152,-5376077,Credit
2024-03-17,Petrol,Transport,-2497,-5378574,Debit
2024-03-30,Received from Rahul,Transfer,-7407,-5385981,Debit
2025-04-07,Doctor Visit,Health,-2034,-5388015,Debit
2024-06-22,Refund,Income,4876,-5383139,Credit
2024-08-23,Movie Tickets,Entertainment,-707,-5383846,Debit
2024-09-25,Uber Ride,Transport,-8306,-5392152,Debit
2024-05-28,Refund,Income,10748,-5381404,Credit
2025-04-28,Myntra Shopping,Shopping,-3533,-5384937,Debit
2024-04-13,Received from Rahul,Transfer,-1822,-5386759,Debit
2024-09-23,Electricity Bill,Utilities,-5468,-5392227,Debit
2024-09-27,Restaurant Bill,Food,-2826,-5395053,Debit
2024-01-26,Flipkart Order,Shopping,-3720,-5398773,Debit
2024-11-21,ATM Withdrawal,Cash,-2166,-5400939,Debit
2024-09-07,UPI to Friend,Transfer,-2960,-5403899,Debit
2024-11-09,Bonus,Income,10750,-5393149,Credit
2024-02-04,Bonus,Income,24311,-5368838,Credit
2024-07-23,Interest Credit,Savings Interest,5843,-5362995,Credit
2024-07-09,YouTube Premium,Entertainment,-9379,-5372374,Debit
2024-01-13,Electronics,Shopping,-8505,-5380879,Debit
2024-04-21,Amazon Purchase,Shopping,-2121,-5383000,Debit
2024-06-01,Spotify,Entertainment,-3990,-5386990,Debit
2024-09-28,Myntra Shopping,Shopping,-2424,-5389414,Debit
2024-10-14,Uber Ride,Transport,-5729,-5395143,Debit
2024-09-26,Doctor Visit,Health,-5355,-5400498,Debit
2024-01-20,Electronics,Shopping,-8482,-5408980,Debit
2024-05-19,ATM Withdrawal,Cash,-2966,-5411946,Debit
2025-05-02,Received from Rahul,Transfer,-2170,-5414116,Debit
2024-08-19,Doctor Visit,Health,-884,-5415000,Debit
2025-04-09,Internet Recharge,Utilities,-1230,-5416230,Debit
2025-03-23,Medical Store,Health,-3118,-5419348,Debit
2025-02-16,Amazon Purchase,Shopping,-8859,-5428207,Debit
2025-04-03,Spotify,Entertainment,-948,-5429155,Debit
2024-03-08,Medical Store,Health,-4293,-5433448,Debit
2025-04-08,UPI to Friend,Transfer,-5382,-5438830,Debit
2025-02-11,Spotify,Entertainment,-6729,-5445559,Debit
2024-07-04,Refund,Income,6362,-5439197,Credit
2024-04-12,ATM Withdrawal,Cash,-1914,-5441111,Debit
2025-05-07,Electricity Bill,Utilities,-8857,-5449968,Debit
2024-07-19,Cash Deposit,Cash,-8338,-5458306,Debit
2024-11-29,Medical Store,Health,-4185,-5462491,Debit
2024-03-13,Electronics,Shopping,-6476,-5468967,Debit
2024-12-05,Bank Transfer,Transfer,-6638,-5475605,Debit
2024-08-22,FD Interest,Savings Interest,11211,-5464394,Credit
2025-01-12,Cash Deposit,Cash,-873,-5465267,Debit
2024-07-27,Myntra Shopping,Shopping,-7783,-5473050,Debit
2025-01-15,Internet Recharge,Utilities,-1395,-5474445,Debit
2025-04-23,FD Interest,Savings Interest,20197,-5454248,Credit
2024-04-04,Internet Recharge,Utilities,-2439,-5456687,Debit
2024-06-06,Movie Tickets,Entertainment,-5308,-5461995,Debit
2024-06-17,Internet Recharge,Utilities,-4689,-5466684,Debit
2024-11-21,YouTube Premium,Entertainment,-6027,-5472711,Debit
2025-04-23,Water Bill,Utilities,-9092,-5481803,Debit
2024-02-17,Water Bill,Utilities,-7068,-5488871,Debit
2024-03-21,Swiggy,Food,-9216,-5498087,Debit
2024-06-28,Electronics,Shopping,-7770,-5505857,Debit
2024-02-23,Swiggy,Food,-9695,-5515552,Debit
2024-08-30,Swiggy,Food,-716,-5516268,Debit
2024-11-01,Restaurant Bill,Food,-5293,-5521561,Debit
2024-11-17,Bank Transfer,Transfer,-7089,-5528650,Debit
2025-03-07,Received from Rahul,Transfer,-237,-5528887,Debit
2024-11-01,Freelance Payment,Income,3412,-5525475,Credit
2024-03-13,Spotify,Entertainment,-4968,-5530443,Debit
2024-02-11,ATM Withdrawal,Cash,-433,-5530876,Debit
2024-06-06,Doctor Visit,Health,-9940,-5540816,Debit
2024-01-16,Water Bill,Utilities,-2866,-5543682,Debit
2025-02-17,Zomato Order,Food,-8151,-5551833,Debit
2025-02-10,ATM Withdrawal,Cash,-7449,-5559282,Debit
2024-10-22,FD Interest,Savings Interest,7854,-5551428,Credit
2024-06-05,Water Bill,Utilities,-6779,-5558207,Debit
2024-11-22,Doctor Visit,Health,-9250,-5567457,Debit
2025-04-03,Freelance Payment,Income,8099,-5559358,Credit
2024-11-01,Water Bill,Utilities,-4136,-5563494,Debit
2024-01-27,Electronics,Shopping,-3466,-5566960,Debit
2024-09-07,Freelance Payment,Income,22409,-5544551,Credit
2025-05-06,Restaurant Bill,Food,-497,-5545048,Debit
2024-02-25,FD Interest,Savings Interest,17937,-5527111,Credit
2024-10-14,Zomato Order,Food,-2573,-5529684,Debit
2024-05-26,Salary Credit,Income,2080,-5527604,Credit
2025-03-22,Doctor Visit,Health,-3651,-5531255,Debit
2024-01-26,Myntra Shopping,Shopping,-7261,-5538516,Debit
2024-03-29,YouTube Premium,Entertainment,-8655,-5547171,Debit
2024-05-17,Salary Credit,Income,9386,-5537785,Credit
2024-05-20,Doctor Visit,Health,-5376,-5543161,Debit
2024-08-20,Interest Credit,Savings Interest,21232,-5521929,Credit
2024-06-29,Amazon Purchase,Shopping,-1223,-5523152,Debit
2024-10-05,Cash Deposit,Cash,-8286,-5531438,Debit
2024-02-19,Train Ticket,Transport,-4570,-5536008,Debit
2025-05-07,Electricity Bill,Utilities,-4464,-5540472,Debit
2025-02-26,Electricity Bill,Utilities,-3506,-5543978,Debit
2024-02-15,Restaurant Bill,Food,-244,-5544222,Debit
2025-04-27,Doctor Visit,Health,-8769,-5552991,Debit
2024-10-28,Flipkart Order,Shopping,-9825,-5562816,Debit
2025-02-12,Swiggy,Food,-130,-5562946,Debit
2025-05-09,FD Interest,Savings Interest,633,-5562313,Credit
2024-09-07,Bank Transfer,Transfer,-5905,-5568218,Debit
2024-08-08,Movie Tickets,Entertainment,-3537,-5571755,Debit
2024-09-30,ATM Withdrawal,Cash,-7876,-5579631,Debit
2024-08-02,ATM Withdrawal,Cash,-8445,-5588076,Debit
2025-04-05,Received from Rahul,Transfer,-1250,-5589326,Debit
2024-11-15,Medical Store,Health,-7122,-5596448,Debit
2024-01-15,Cash Deposit,Cash,-6432,-5602880,Debit
2024-10-25,Cash Deposit,Cash,-4891,-5607771,Debit
2024-04-01,UPI to Friend,Transfer,-9044,-5616815,Debit
2025-05-04,Train Ticket,Transport,-5272,-5622087,Debit
2024-01-19,Bank Transfer,Transfer,-5058,-5627145,Debit
2024-04-29,Petrol,Transport,-460,-5627605,Debit
2024-04-23,Zomato Order,Food,-1070,-5628675,Debit
2024-08-06,Spotify,Entertainment,-4272,-5632947,Debit
2024-08-18,Water Bill,Utilities,-3666,-5636613,Debit
2024-02-15,Water Bill,Utilities,-5688,-5642301,Debit
2025-02-21,Cafe Coffee Day,Food,-4674,-5646975,Debit
2024-01-10,Electricity Bill,Utilities,-6982,-5653957,Debit
2025-02-06,Train Ticket,Transport,-506,-5654463,Debit
2024-07-31,Myntra Shopping,Shopping,-8263,-5662726,Debit
2024-03-23,Uber Ride,Transport,-6684,-5669410,Debit
2025-03-04,Spotify,Entertainment,-8572,-5677982,Debit
2024-09-25,Interest Credit,Savings Interest,23126,-5654856,Credit
2024-11-03,Medical Store,Health,-9563,-5664419,Debit
2024-10-06,Interest Credit,Savings Interest,28586,-5635833,Credit
2024-06-22,Cafe Coffee Day,Food,-5361,-5641194,Debit
2025-03-15,Received from Rahul,Transfer,-4617,-5645811,Debit
2025-04-06,Medical Store,Health,-1694,-5647505,Debit
2024-09-20,FD Interest,Savings Interest,17626,-5629879,Credit
2024-01-08,Refund,Income,28454,-5601425,Credit
2025-01-09,Internet Recharge,Utilities,-1258,-5602683,Debit
2024-11-04,Petrol,Transport,-5382,-5608065,Debit
2025-02-28,Freelance Payment,Income,14532,-5593533,Credit
2025-02-20,YouTube Premium,Entertainment,-7857,-5601390,Debit
2024-01-08,Cafe Coffee Day,Food,-1800,-5603190,Debit
2024-08-18,Petrol,Transport,-9054,-5612244,Debit
2024-06-22,Salary Credit,Income,23544,-5588700,Credit
2025-05-15,Petrol,Transport,-4795,-5593495,Debit
2025-01-23,Interest Credit,Savings Interest,27884,-5565611,Credit
2024-07-19,Restaurant Bill,Food,-6288,-5571899,Debit
2025-05-03,Swiggy,Food,-121,-5572020,Debit
2025-01-05,FD Interest,Savings Interest,17590,-5554430,Credit
2025-05-03,Train Ticket,Transport,-6967,-5561397,Debit
2024-09-17,Flipkart Order,Shopping,-7947,-5569344,Debit
2024-07-07,Medical Store,Health,-5399,-5574743,Debit
2024-04-20,Refund,Income,27366,-5547377,Credit
2024-12-19,Refund,Income,21536,-5525841,Credit
2024-06-08,Cafe Coffee Day,Food,-2411,-5528252,Debit
2024-08-31,UPI to Friend,Transfer,-7303,-5535555,Debit
2024-06-10,Interest Credit,Savings Interest,2497,-5533058,Credit
2024-09-14,Spotify,Entertainment,-719,-5533777,Debit
2024-09-28,Restaurant Bill,Food,-4556,-5538333,Debit
2024-05-07,Electricity Bill,Utilities,-8490,-5546823,Debit
2024-01-22,Bank Transfer,Transfer,-2016,-5548839,Debit
2024-07-02,Movie Tickets,Entertainment,-6540,-5555379,Debit
2024-02-04,ATM Withdrawal,Cash,-9767,-5565146,Debit
2024-09-02,Movie Tickets,Entertainment,-4601,-5569747,Debit
2024-04-30,Myntra Shopping,Shopping,-7110,-5576857,Debit
2024-01-27,Cafe Coffee Day,Food,-3940,-5580797,Debit
2024-12-28,Bank Transfer,Transfer,-3533,-5584330,Debit
2024-02-06,Amazon Purchase,Shopping,-7987,-5592317,Debit
2024-05-20,Electronics,Shopping,-2635,-5594952,Debit
2024-03-23,Amazon Purchase,Shopping,-3440,-5598392,Debit
2024-10-21,Bank Transfer,Transfer,-4809,-5603201,Debit
2024-01-17,Internet Recharge,Utilities,-9801,-5613002,Debit
2024-05-20,Uber Ride,Transport,-2437,-5615439,Debit
2024-08-02,Cash Deposit,Cash,-3600,-5619039,Debit
2024-12-25,Amazon Purchase,Shopping,-2167,-5621206,Debit
2024-12-08,Spotify,Entertainment,-6100,-5627306,Debit
2024-04-23,Interest Credit,Savings Interest,13398,-5613908,Credit
2024-09-08,Medical Store,Health,-6502,-5620410,Debit
2024-11-10,Amazon Purchase,Shopping,-1083,-5621493,Debit
2025-02-13,Received from Rahul,Transfer,-1621,-5623114,Debit
2025-01-20,Interest Credit,Savings Interest,23943,-5599171,Credit
2024-07-03,Electricity Bill,Utilities,-8922,-5608093,Debit
2024-06-04,Internet Recharge,Utilities,-1890,-5609983,Debit
2024-11-18,Freelance Payment,Income,10154,-5599829,Credit
2024-12-09,YouTube Premium,Entertainment,-537,-5600366,Debit
2024-01-14,Salary Credit,Income,4251,-5596115,Credit
2025-02-12,Train Ticket,Transport,-1033,-5597148,Debit
2024-04-15,ATM Withdrawal,Cash,-5038,-5602186,Debit
2024-05-16,Spotify,Entertainment,-8491,-5610677,Debit
2024-06-14,Received from Rahul,Transfer,-9658,-5620335,Debit
2024-06-13,Uber Ride,Transport,-928,-5621263,Debit
2024-02-06,Interest Credit,Savings Interest,10092,-5611171,Credit
2025-01-02,Bank Transfer,Transfer,-5741,-5616912,Debit
2024-09-01,Petrol,Transport,-5948,-5622860,Debit
2024-06-19,Cash Deposit,Cash,-7657,-5630517,Debit
2025-02-09,Electricity Bill,Utilities,-5674,-5636191,Debit
2025-04-23,Cafe Coffee Day,Food,-2834,-5639025,Debit
2024-05-11,Electronics,Shopping,-8621,-5647646,Debit
2025-04-21,Water Bill,Utilities,-1259,-5648905,Debit
2024-05-16,Freelance Payment,Income,12045,-5636860,Credit
2024-10-19,Flipkart Order,Shopping,-9967,-5646827,Debit
2025-03-07,Bank Transfer,Transfer,-9483,-5656310,Debit
2024-02-24,Salary Credit,Income,4685,-5651625,Credit
2025-01-23,Train Ticket,Transport,-4590,-5656215,Debit
2024-11-27,Restaurant Bill,Food,-7970,-5664185,Debit
2025-03-25,Cash Deposit,Cash,-4390,-5668575,Debit
2025-01-26,Refund,Income,9897,-5658678,Credit
2025-01-28,Uber Ride,Transport,-2592,-5661270,Debit
2025-04-09,ATM Withdrawal,Cash,-7680,-5668950,Debit
2024-03-31,Flipkart Order,Shopping,-8408,-5677358,Debit
2024-02-03,Uber Ride,Transport,-3489,-5680847,Debit
2024-10-10,Water Bill,Utilities,-7726,-5688573,Debit
2025-01-26,YouTube Premium,Entertainment,-7810,-5696383,Debit
2024-02-13,Water Bill,Utilities,-4640,-5701023,Debit
2025-02-04,FD Interest,Savings Interest,25705,-5675318,Credit
2025-02-06,Electronics,Shopping,-6898,-5682216,Debit
2024-02-11,Myntra Shopping,Shopping,-7632,-5689848,Debit
2024-12-24,FD Interest,Savings Interest,9537,-5680311,Credit
2024-09-01,Train Ticket,Transport,-668,-5680979,Debit
2024-12-12,Petrol,Transport,-8282,-5689261,Debit
2024-08-24,Freelance Payment,Income,16711,-5672550,Credit
2024-05-08,Cash Deposit,Cash,-9784,-5682334,Debit
2024-03-23,Train Ticket,Transport,-5337,-5687671,Debit
2024-05-25,Myntra Shopping,Shopping,-7837,-5695508,Debit
2024-09-15,YouTube Premium,Entertainment,-7504,-5703012,Debit
2024-07-13,Bonus,Income,3454,-5699558,Credit
2025-01-22,Amazon Purchase,Shopping,-3857,-5703415,Debit
2024-09-30,Petrol,Transport,-2339,-5705754,Debit
2024-12-28,FD Interest,Savings Interest,15360,-5690394,Credit
2025-03-04,Petrol,Transport,-3204,-5693598,Debit
2024-11-11,Electricity Bill,Utilities,-9990,-5703588,Debit
2024-07-27,Water Bill,Utilities,-310,-5703898,Debit
2024-02-17,Zomato Order,Food,-6600,-5710498,Debit
2024-11-21,Uber Ride,Transport,-531,-5711029,Debit
2025-01-01,Doctor Visit,Health,-2272,-5713301,Debit
2025-05-10,Spotify,Entertainment,-2057,-5715358,Debit
2024-06-28,Medical Store,Health,-4997,-5720355,Debit
2024-04-09,Cash Deposit,Cash,-3538,-5723893,Debit
2024-04-17,Received from Rahul,Transfer,-2993,-5726886,Debit
2024-03-19,Water Bill,Utilities,-4629,-5731515,Debit
2024-07-25,Restaurant Bill,Food,-9835,-5741350,Debit
2024-09-12,Medical Store,Health,-6339,-5747689,Debit
2024-06-01,Swiggy,Food,-5495,-5753184,Debit
2024-02-03,FD Interest,Savings Interest,11398,-5741786,Credit
2025-02-01,Freelance Payment,Income,6643,-5735143,Credit
2024-01-23,Cafe Coffee Day,Food,-2456,-5737599,Debit
2024-12-23,Uber Ride,Transport,-3099,-5740698,Debit
2025-01-25,Flipkart Order,Shopping,-8461,-5749159,Debit
2024-10-25,Amazon Purchase,Shopping,-5422,-5754581,Debit
2025-01-02,FD Interest,Savings Interest,5388,-5749193,Credit
2024-03-20,Interest Credit,Savings Interest,4849,-5744344,Credit
2024-04-12,Uber Ride,Transport,-7411,-5751755,Debit
2024-01-23,YouTube Premium,Entertainment,-9286,-5761041,Debit
2024-09-24,Medical Store,Health,-618,-5761659,Debit
2024-01-10,Doctor Visit,Health,-4585,-5766244,Debit
2024-05-06,Cash Deposit,Cash,-8383,-5774627,Debit
2024-10-12,Medical Store,Health,-1897,-5776524,Debit
2025-04-10,UPI to Friend,Transfer,-7019,-5783543,Debit
2024-07-18,ATM Withdrawal,Cash,-7201,-5790744,Debit
2025-01-26,Received from Rahul,Transfer,-5052,-5795796,Debit
2024-09-16,Salary Credit,Income,21271,-5774525,Credit
2025-03-10,Spotify,Entertainment,-5328,-5779853,Debit
2025-03-17,Bank Transfer,Transfer,-5558,-5785411,Debit
2024-02-24,Freelance Payment,Income,4177,-5781234,Credit
2024-11-05,Spotify,Entertainment,-7943,-5789177,Debit
2025-05-10,UPI to Friend,Transfer,-8210,-5797387,Debit
2024-04-18,Bank Transfer,Transfer,-2789,-5800176,Debit
2024-03-01,Medical Store,Health,-2362,-5802538,Debit
2024-07-25,Electricity Bill,Utilities,-6780,-5809318,Debit
2024-07-22,UPI to Friend,Transfer,-4352,-5813670,Debit
2024-08-27,Flipkart Order,Shopping,-4430,-5818100,Debit
2025-04-13,Amazon Purchase,Shopping,-6505,-5824605,Debit
2024-02-13,Spotify,Entertainment,-3958,-5828563,Debit
2024-04-11,Uber Ride,Transport,-7733,-5836296,Debit
2025-02-07,Myntra Shopping,Shopping,-9364,-5845660,Debit
2024-02-13,Cash Deposit,Cash,-4135,-5849795,Debit
2024-08-04,Cash Deposit,Cash,-3847,-5853642,Debit
2024-04-24,Doctor Visit,Health,-4275,-5857917,Debit
2025-02-22,UPI to Friend,Transfer,-236,-5858153,Debit
2024-10-14,Zomato Order,Food,-4286,-5862439,Debit
2024-03-28,Doctor Visit,Health,-1833,-5864272,Debit
2024-11-09,Petrol,Transport,-2109,-5866381,Debit
2025-02-16,Electricity Bill,Utilities,-3007,-5869388,Debit
2024-03-22,Received from Rahul,Transfer,-6467,-5875855,Debit
2024-04-23,Doctor Visit,Health,-802,-5876657,Debit
2024-02-01,Internet Recharge,Utilities,-4236,-5880893,Debit
2024-09-21,Cafe Coffee Day,Food,-4126,-5885019,Debit
2024-01-13,Restaurant Bill,Food,-998,-5886017,Debit
2025-01-20,Refund,Income,29279,-5856738,Credit
2024-10-02,Received from Rahul,Transfer,-8322,-5865060,Debit
2024-03-28,Movie Tickets,Entertainment,-7907,-5872967,Debit
2025-02-04,Uber Ride,Transport,-5061,-5878028,Debit
2024-11-02,Internet Recharge,Utilities,-5508,-5883536,Debit
2024-05-26,Bonus,Income,27710,-5855826,Credit
2024-05-13,Medical Store,Health,-6247,-5862073,Debit
2025-03-15,Swiggy,Food,-7464,-5869537,Debit
2024-05-12,UPI to Friend,Transfer,-1008,-5870545,Debit
2024-03-26,Movie Tickets,Entertainment,-8281,-5878826,Debit
2024-12-15,Train Ticket,Transport,-6834,-5885660,Debit
2024-07-16,Myntra Shopping,Shopping,-7596,-5893256,Debit
2024-09-22,FD Interest,Savings Interest,23916,-5869340,Credit
2025-01-04,Doctor Visit,Health,-5987,-5875327,Debit
2024-02-05,Salary Credit,Income,3483,-5871844,Credit
2025-05-01,UPI to Friend,Transfer,-4716,-5876560,Debit
2024-09-21,Train Ticket,Transport,-368,-5876928,Debit
2025-01-30,Doctor Visit,Health,-1800,-5878728,Debit
2024-10-13,Internet Recharge,Utilities,-677,-5879405,Debit
2024-05-04,Cash Deposit,Cash,-109,-5879514,Debit
2024-12-29,Amazon Purchase,Shopping,-757,-5880271,Debit
2025-03-31,Uber Ride,Transport,-523,-5880794,Debit
2024-10-12,Medical Store,Health,-5373,-5886167,Debit
2024-02-27,Uber Ride,Transport,-9723,-5895890,Debit
2024-07-01,Interest Credit,Savings Interest,25771,-5870119,Credit
2025-03-09,Cafe Coffee Day,Food,-7737,-5877856,Debit
2024-03-15,Swiggy,Food,-9222,-5887078,Debit
2025-03-22,YouTube Premium,Entertainment,-4444,-5891522,Debit
2024-04-24,FD Interest,Savings Interest,17232,-5874290,Credit
2024-01-06,Movie Tickets,Entertainment,-2087,-5876377,Debit
2024-09-13,FD Interest,Savings Interest,5055,-5871322,Credit
2024-06-02,Cafe Coffee Day,Food,-2529,-5873851,Debit
2025-04-03,ATM Withdrawal,Cash,-6236,-5880087,Debit
2025-03-15,YouTube Premium,Entertainment,-2263,-5882350,Debit
2025-04-23,Zomato Order,Food,-4593,-5886943,Debit
2024-11-03,Bank Transfer,Transfer,-3027,-5889970,Debit
2024-07-20,Salary Credit,Income,11059,-5878911,Credit
2024-06-20,Zomato Order,Food,-5975,-5884886,Debit
2025-02-25,Flipkart Order,Shopping,-8409,-5893295,Debit
2024-10-26,Swiggy,Food,-3831,-5897126,Debit
2024-02-10,Cafe Coffee Day,Food,-2536,-5899662,Debit
2024-12-08,Water Bill,Utilities,-6261,-5905923,Debit
2024-04-30,ATM Withdrawal,Cash,-7897,-5913820,Debit
2024-08-04,Water Bill,Utilities,-6621,-5920441,Debit
2024-01-06,Bank Transfer,Transfer,-5379,-5925820,Debit
2024-10-17,Doctor Visit,Health,-7832,-5933652,Debit
2024-11-05,UPI to Friend,Transfer,-3481,-5937133,Debit
2024-07-27,Amazon Purchase,Shopping,-3303,-5940436,Debit
2024-07-01,Medical Store,Health,-7748,-5948184,Debit
2024-02-27,Amazon Purchase,Shopping,-8375,-5956559,Debit
2025-03-01,FD Interest,Savings Interest,6594,-5949965,Credit
2024-11-11,UPI to Friend,Transfer,-3445,-5953410,Debit
2024-10-24,Cafe Coffee Day,Food,-7231,-5960641,Debit
2025-01-30,Cafe Coffee Day,Food,-416,-5961057,Debit
2025-04-17,Medical Store,Health,-6563,-5967620,Debit
2025-01-23,Doctor Visit,Health,-7624,-5975244,Debit
2024-05-14,Electronics,Shopping,-5640,-5980884,Debit
2025-03-09,Bonus,Income,1056,-5979828,Credit
2024-07-13,Cash Deposit,Cash,-5618,-5985446,Debit
2024-03-04,YouTube Premium,Entertainment,-4312,-5989758,Debit
2025-05-11,Received from Rahul,Transfer,-5597,-5995355,Debit
2025-01-30,ATM Withdrawal,Cash,-9990,-6005345,Debit
2025-03-24,Electricity Bill,Utilities,-3871,-6009216,Debit
2024-08-16,Bank Transfer,Transfer,-8992,-6018208,Debit
2024-08-09,YouTube Premium,Entertainment,-7378,-6025586,Debit
2024-07-20,Cash Deposit,Cash,-6387,-6031973,Debit
2025-02-24,Cafe Coffee Day,Food,-3629,-6035602,Debit
2025-03-08,Uber Ride,Transport,-6564,-6042166,Debit
2024-05-15,Interest Credit,Savings Interest,1633,-6040533,Credit
2025-01-19,Petrol,Transport,-1572,-6042105,Debit
2024-07-08,Received from Rahul,Transfer,-4863,-6046968,Debit
2024-11-23,Uber Ride,Transport,-5645,-6052613,Debit
2024-08-24,Bank Transfer,Transfer,-6560,-6059173,Debit
2025-02-21,Refund,Income,9784,-6049389,Credit
2024-02-04,Amazon Purchase,Shopping,-2238,-6051627,Debit
2025-02-01,Restaurant Bill,Food,-4960,-6056587,Debit
2024-07-26,Interest Credit,Savings Interest,14868,-6041719,Credit
2025-04-07,Electricity Bill,Utilities,-5200,-6046919,Debit
2024-08-30,Cash Deposit,Cash,-6022,-6052941,Debit
2025-03-31,ATM Withdrawal,Cash,-7978,-6060919,Debit
2024-04-30,Spotify,Entertainment,-7878,-6068797,Debit
2024-06-29,Freelance Payment,Income,28618,-6040179,Credit
2025-02-09,Electronics,Shopping,-737,-6040916,Debit
2024-05-24,ATM Withdrawal,Cash,-7222,-6048138,Debit
2024-08-27,Freelance Payment,Income,13285,-6034853,Credit
2024-05-21,Internet Recharge,Utilities,-7188,-6042041,Debit
2024-06-12,ATM Withdrawal,Cash,-7079,-6049120,Debit
2024-01-29,Bank Transfer,Transfer,-4350,-6053470,Debit
2024-03-29,YouTube Premium,Entertainment,-8991,-6062461,Debit
2024-05-03,Bank Transfer,Transfer,-6175,-6068636,Debit
2025-05-11,Received from Rahul,Transfer,-3361,-6071997,Debit
2025-03-04,Interest Credit,Savings Interest,22730,-6049267,Credit
2024-01-18,Refund,Income,20724,-6028543,Credit
2024-07-29,UPI to Friend,Transfer,-3208,-6031751,Debit
2024-07-29,Water Bill,Utilities,-4699,-6036450,Debit
2025-03-02,Doctor Visit,Health,-9978,-6046428,Debit
2024-03-13,Bank Transfer,Transfer,-3584,-6050012,Debit
2025-01-28,Flipkart Order,Shopping,-545,-6050557,Debit
2025-02-14,ATM Withdrawal,Cash,-6189,-6056746,Debit
2024-05-27,YouTube Premium,Entertainment,-8717,-6065463,Debit
2024-01-29,Electronics,Shopping,-5375,-6070838,Debit
2024-07-03,Cash Deposit,Cash,-5016,-6075854,Debit
2024-08-21,Spotify,Entertainment,-266,-6076120,Debit
2025-05-11,Doctor Visit,Health,-3630,-6079750,Debit
2024-08-31,Doctor Visit,Health,-9336,-6089086,Debit
2024-05-20,Refund,Income,13384,-6075702,Credit
2024-05-09,Interest Credit,Savings Interest,963,-6074739,Credit
2024-04-25,Received from Rahul,Transfer,-8751,-6083490,Debit
2024-06-21,Train Ticket,Transport,-869,-6084359,Debit
2025-02-18,Cash Deposit,Cash,-2094,-6086453,Debit
2024-08-23,Petrol,Transport,-6366,-6092819,Debit
2025-03-11,Myntra Shopping,Shopping,-6555,-6099374,Debit
2024-06-18,Freelance Payment,Income,18364,-6081010,Credit
2024-10-25,ATM Withdrawal,Cash,-5140,-6086150,Debit
2024-05-21,Train Ticket,Transport,-178,-6086328,Debit
2025-05-05,Salary Credit,Income,26228,-6060100,Credit
2025-05-12,Movie Tickets,Entertainment,-9767,-6069867,Debit
2025-01-08,Myntra Shopping,Shopping,-6900,-6076767,Debit
2024-02-11,Zomato Order,Food,-6022,-6082789,Debit
2024-04-10,Salary Credit,Income,6922,-6075867,Credit
2024-09-14,UPI to Friend,Transfer,-9366,-6085233,Debit
2024-08-03,Received from Rahul,Transfer,-2326,-6087559,Debit
2024-11-04,Amazon Purchase,Shopping,-4687,-6092246,Debit
2024-04-16,ATM Withdrawal,Cash,-127,-6092373,Debit
2024-04-05,Swiggy,Food,-6393,-6098766,Debit
2024-12-31,Refund,Income,17446,-6081320,Credit
2024-01-21,Flipkart Order,Shopping,-7226,-6088546,Debit
2025-02-01,Cafe Coffee Day,Food,-5305,-6093851,Debit
2025-03-09,Spotify,Entertainment,-676,-6094527,Debit
2024-04-06,Doctor Visit,Health,-3003,-6097530,Debit
2024-06-26,Bonus,Income,20797,-6076733,Credit
2024-08-13,Doctor Visit,Health,-7582,-6084315,Debit
2024-09-10,FD Interest,Savings Interest,11345,-6072970,Credit
2025-04-03,Restaurant Bill,Food,-4335,-6077305,Debit
2025-04-10,Internet Recharge,Utilities,-5687,-6082992,Debit
2025-01-20,Medical Store,Health,-920,-6083912,Debit
2025-01-15,Zomato Order,Food,-2355,-6086267,Debit
2024-10-01,Electricity Bill,Utilities,-2808,-6089075,Debit
2024-04-03,Salary Credit,Income,18223,-6070852,Credit
2025-01-03,Water Bill,Utilities,-5365,-6076217,Debit
2024-03-11,Cash Deposit,Cash,-7157,-6083374,Debit
2024-10-29,Received from Rahul,Transfer,-2248,-6085622,Debit
2025-04-22,Cash Deposit,Cash,-2494,-6088116,Debit
2024-11-16,FD Interest,Savings Interest,23168,-6064948,Credit
2024-11-05,Bonus,Income,7456,-6057492,Credit
2024-05-18,Internet Recharge,Utilities,-6116,-6063608,Debit
2025-04-15,FD Interest,Savings Interest,11480,-6052128,Credit
2025-01-06,Bank Transfer,Transfer,-5083,-6057211,Debit
2024-03-10,Movie Tickets,Entertainment,-9515,-6066726,Debit
2025-02-06,Myntra Shopping,Shopping,-9101,-6075827,Debit
2024-07-14,Amazon Purchase,Shopping,-5707,-6081534,Debit
2025-02-27,Cash Deposit,Cash,-3986,-6085520,Debit
2025-05-12,Uber Ride,Transport,-8748,-6094268,Debit
2024-12-03,Uber Ride,Transport,-6015,-6100283,Debit
2024-03-20,Zomato Order,Food,-1554,-6101837,Debit
2025-02-21,ATM Withdrawal,Cash,-6032,-6107869,Debit
2024-12-31,FD Interest,Savings Interest,3226,-6104643,Credit
2024-05-20,Myntra Shopping,Shopping,-9527,-6114170,Debit
2024-04-06,Received from Rahul,Transfer,-2704,-6116874,Debit
2024-11-23,Water Bill,Utilities,-6057,-6122931,Debit
2025-01-27,Uber Ride,Transport,-3315,-6126246,Debit
2024-03-07,Water Bill,Utilities,-3312,-6129558,Debit
2025-03-01,Medical Store,Health,-5711,-6135269,Debit
2024-09-25,Bank Transfer,Transfer,-6878,-6142147,Debit
2024-08-10,Internet Recharge,Utilities,-7518,-6149665,Debit
2024-08-08,FD Interest,Savings Interest,19260,-6130405,Credit
2024-10-14,Salary Credit,Income,22274,-6108131,Credit
2024-05-06,Movie Tickets,Entertainment,-3045,-6111176,Debit
2024-12-13,Interest Credit,Savings Interest,12918,-6098258,Credit
2025-01-21,Cash Deposit,Cash,-4674,-6102932,Debit
2024-04-09,Movie Tickets,Entertainment,-467,-6103399,Debit
2024-06-15,Train Ticket,Transport,-8978,-6112377,Debit
2025-05-08,Electricity Bill,Utilities,-4903,-6117280,Debit
2024-03-27,Electricity Bill,Utilities,-7066,-6124346,Debit
2024-06-09,Swiggy,Food,-1304,-6125650,Debit
2024-02-09,Cash Deposit,Cash,-5381,-6131031,Debit
2025-01-06,Salary Credit,Income,915,-6130116,Credit
2024-05-14,Medical Store,Health,-1302,-6131418,Debit
2025-04-11,Electricity Bill,Utilities,-185,-6131603,Debit
2024-04-30,Doctor Visit,Health,-1160,-6132763,Debit
2025-03-22,Cash Deposit,Cash,-8433,-6141196,Debit
2024-07-28,Cash Deposit,Cash,-2010,-6143206,Debit
2024-05-18,ATM Withdrawal,Cash,-3518,-6146724,Debit
2024-05-16,Electronics,Shopping,-3081,-6149805,Debit
2024-05-20,Myntra Shopping,Shopping,-9071,-6158876,Debit
2024-11-26,Doctor Visit,Health,-3765,-6162641,Debit
2024-03-24,YouTube Premium,Entertainment,-5030,-6167671,Debit
2024-12-19,Amazon Purchase,Shopping,-3962,-6171633,Debit
2025-04-13,Movie Tickets,Entertainment,-1032,-6172665,Debit
2024-07-19,Medical Store,Health,-2278,-6174943,Debit
2024-07-28,Medical Store,Health,-4179,-6179122,Debit
2024-04-12,UPI to Friend,Transfer,-6274,-6185396,Debit
2024-07-28,ATM Withdrawal,Cash,-7822,-6193218,Debit
2024-04-19,Water Bill,Utilities,-516,-6193734,Debit
2024-02-08,Uber Ride,Transport,-7006,-6200740,Debit
2025-03-14,Movie Tickets,Entertainment,-3434,-6204174,Debit
2024-11-14,Train Ticket,Transport,-8426,-6212600,Debit
2024-08-12,Flipkart Order,Shopping,-3548,-6216148,Debit
2024-04-14,Cafe Coffee Day,Food,-6238,-6222386,Debit
2025-03-31,YouTube Premium,Entertainment,-891,-6223277,Debit
2024-01-04,Refund,Income,18350,-6204927,Credit
2024-10-17,Cash Deposit,Cash,-7807,-6212734,Debit
2024-12-26,Movie Tickets,Entertainment,-9911,-6222645,Debit
2025-02-25,Restaurant Bill,Food,-4958,-6227603,Debit
2025-03-01,FD Interest,Savings Interest,3801,-6223802,Credit
2024-08-23,UPI to Friend,Transfer,-3208,-6227010,Debit
2024-02-28,YouTube Premium,Entertainment,-5506,-6232516,Debit
2024-12-26,Movie Tickets,Entertainment,-5352,-6237868,Debit
2024-06-07,Bank Transfer,Transfer,-7000,-6244868,Debit
2024-06-21,Doctor Visit,Health,-1127,-6245995,Debit
2024-08-08,Electricity Bill,Utilities,-9872,-6255867,Debit
2024-10-31,Interest Credit,Savings Interest,4634,-6251233,Credit
2024-09-11,Internet Recharge,Utilities,-5110,-6256343,Debit
2024-02-29,Restaurant Bill,Food,-8706,-6265049,Debit
2024-12-09,ATM Withdrawal,Cash,-3318,-6268367,Debit
2025-02-16,Spotify,Entertainment,-2961,-6271328,Debit
2024-12-17,Spotify,Entertainment,-1353,-6272681,Debit
2024-10-24,Zomato Order,Food,-1672,-6274353,Debit
2024-04-02,YouTube Premium,Entertainment,-9064,-6283417,Debit
2024-11-01,Salary Credit,Income,29156,-6254261,Credit
2024-07-08,Doctor Visit,Health,-7654,-6261915,Debit
2024-06-09,Spotify,Entertainment,-2102,-6264017,Debit
2024-07-13,Interest Credit,Savings Interest,21501,-6242516,Credit
2024-12-16,Electronics,Shopping,-3242,-6245758,Debit
2024-07-25,FD Interest,Savings Interest,24748,-6221010,Credit
2025-05-05,Internet Recharge,Utilities,-272,-6221282,Debit
2024-05-13,Doctor Visit,Health,-3890,-6225172,Debit
2024-11-12,ATM Withdrawal,Cash,-2837,-6228009,Debit
2025-05-03,Freelance Payment,Income,29600,-6198409,Credit
2024-07-22,Zomato Order,Food,-9128,-6207537,Debit
2025-04-03,Swiggy,Food,-8606,-6216143,Debit
2024-05-17,ATM Withdrawal,Cash,-5558,-6221701,Debit
2024-10-12,ATM Withdrawal,Cash,-4567,-6226268,Debit
2024-11-17,Received from Rahul,Transfer,-9028,-6235296,Debit
2024-03-05,Refund,Income,22040,-6213256,Credit
2024-06-28,Spotify,Entertainment,-9076,-6222332,Debit
2025-05-01,Spotify,Entertainment,-7004,-6229336,Debit
2025-04-10,ATM Withdrawal,Cash,-7858,-6237194,Debit
2024-07-23,Swiggy,Food,-2025,-6239219,Debit
2024-08-28,Flipkart Order,Shopping,-2143,-6241362,Debit
2024-06-21,Received from Rahul,Transfer,-6818,-6248180,Debit
2024-03-06,Swiggy,Food,-2814,-6250994,Debit
2024-11-13,Freelance Payment,Income,5457,-6245537,Credit
2024-11-17,Restaurant Bill,Food,-773,-6246310,Debit
2024-05-11,Electricity Bill,Utilities,-281,-6246591,Debit
2024-08-01,Petrol,Transport,-4913,-6251504,Debit
2024-12-25,FD Interest,Savings Interest,24917,-6226587,Credit
2024-09-22,ATM Withdrawal,Cash,-347,-6226934,Debit
2024-02-03,Amazon Purchase,Shopping,-8536,-6235470,Debit
2024-10-26,Electricity Bill,Utilities,-2919,-6238389,Debit
2024-03-03,Cafe Coffee Day,Food,-2297,-6240686,Debit
2024-11-14,Electricity Bill,Utilities,-4963,-6245649,Debit
2024-06-27,Cash Deposit,Cash,-5547,-6251196,Debit
2024-04-30,Petrol,Transport,-4653,-6255849,Debit
2024-11-02,Amazon Purchase,Shopping,-9059,-6264908,Debit
2024-05-08,Uber Ride,Transport,-5930,-6270838,Debit
2024-10-10,Restaurant Bill,Food,-8472,-6279310,Debit
2025-05-04,FD Interest,Savings Interest,4276,-6275034,Credit
2024-07-30,Cafe Coffee Day,Food,-1995,-6277029,Debit
2025-02-10,Swiggy,Food,-3693,-6280722,Debit
2024-07-20,Electricity Bill,Utilities,-2556,-6283278,Debit
2024-10-17,Salary Credit,Income,13683,-6269595,Credit
2024-03-12,Bonus,Income,9323,-6260272,Credit
2024-02-09,Swiggy,Food,-3594,-6263866,Debit
2025-02-24,FD Interest,Savings Interest,15279,-6248587,Credit
2024-01-22,Electricity Bill,Utilities,-2156,-6250743,Debit
2024-06-11,Bonus,Income,21261,-6229482,Credit
2024-05-02,Amazon Purchase,Shopping,-4053,-6233535,Debit
2025-03-25,Movie Tickets,Entertainment,-5199,-6238734,Debit
2024-01-05,Interest Credit,Savings Interest,26887,-6211847,Credit
2024-12-26,Cash Deposit,Cash,-9296,-6221143,Debit
2024-02-18,Electronics,Shopping,-5799,-6226942,Debit
2025-05-02,Spotify,Entertainment,-3809,-6230751,Debit
2024-09-13,Received from Rahul,Transfer,-4430,-6235181,Debit
2025-04-11,Train Ticket,Transport,-3828,-6239009,Debit
2024-05-07,Amazon Purchase,Shopping,-5219,-6244228,Debit
2025-04-10,Received from Rahul,Transfer,-8800,-6253028,Debit
2025-01-05,Water Bill,Utilities,-5336,-6258364,Debit
2024-06-05,Electricity Bill,Utilities,-5394,-6263758,Debit
2025-05-09,Salary Credit,Income,4376,-6259382,Credit
2024-07-28,Water Bill,Utilities,-2601,-6261983,Debit
2024-01-31,Medical Store,Health,-930,-6262913,Debit
2025-05-11,Water Bill,Utilities,-7764,-6270677,Debit
2024-12-17,Spotify,Entertainment,-417,-6271094,Debit
2025-04-20,ATM Withdrawal,Cash,-9040,-6280134,Debit
2025-02-11,Cash Deposit,Cash,-6131,-6286265,Debit
2024-01-03,Swiggy,Food,-904,-6287169,Debit
2024-09-16,Medical Store,Health,-9179,-6296348,Debit
2025-01-05,YouTube Premium,Entertainment,-4314,-6300662,Debit
2024-04-01,Amazon Purchase,Shopping,-4267,-6304929,Debit
2024-09-08,FD Interest,Savings Interest,24565,-6280364,Credit
2024-06-11,UPI to Friend,Transfer,-9487,-6289851,Debit
2024-12-08,Internet Recharge,Utilities,-9091,-6298942,Debit
2025-04-26,Medical Store,Health,-1689,-6300631,Debit
2024-01-22,UPI to Friend,Transfer,-7683,-6308314,Debit
2024-05-11,Bonus,Income,16668,-6291646,Credit
2024-12-22,Interest Credit,Savings Interest,1915,-6289731,Credit
2024-06-13,Salary Credit,Income,23562,-6266169,Credit
2024-06-17,Train Ticket,Transport,-3021,-6269190,Debit
2025-02-27,Doctor Visit,Health,-1000,-6270190,Debit
2024-07-10,YouTube Premium,Entertainment,-7980,-6278170,Debit
2024-05-20,Electricity Bill,Utilities,-7962,-6286132,Debit
2024-11-06,Flipkart Order,Shopping,-3961,-6290093,Debit
2025-02-07,Petrol,Transport,-4179,-6294272,Debit
2025-04-18,Cash Deposit,Cash,-2609,-6296881,Debit
2024-11-27,Electronics,Shopping,-9638,-6306519,Debit
2024-07-08,Received from Rahul,Transfer,-6213,-6312732,Debit
2024-10-29,Movie Tickets,Entertainment,-9736,-6322468,Debit
2025-02-16,Internet Recharge,Utilities,-9929,-6332397,Debit
2024-05-29,Uber Ride,Transport,-8330,-6340727,Debit
2024-08-11,Cash Deposit,Cash,-3268,-6343995,Debit
2025-02-27,Amazon Purchase,Shopping,-5800,-6349795,Debit
2024-02-14,Petrol,Transport,-5980,-6355775,Debit
2024-07-11,Swiggy,Food,-9728,-6365503,Debit
2025-04-11,Train Ticket,Transport,-1708,-6367211,Debit
2024-07-12,Received from Rahul,Transfer,-8791,-6376002,Debit
2025-04-21,Medical Store,Health,-8279,-6384281,Debit
2024-10-03,Amazon Purchase,Shopping,-3249,-6387530,Debit
2024-01-25,UPI to Friend,Transfer,-7430,-6394960,Debit
2024-08-20,Doctor Visit,Health,-3233,-6398193,Debit
2025-04-15,Myntra Shopping,Shopping,-2695,-6400888,Debit
2024-10-29,UPI to Friend,Transfer,-3655,-6404543,Debit
2025-04-05,Received from Rahul,Transfer,-8977,-6413520,Debit
2024-02-19,Water Bill,Utilities,-6577,-6420097,Debit
2024-02-27,Doctor Visit,Health,-1464,-6421561,Debit
2024-06-13,Myntra Shopping,Shopping,-1349,-6422910,Debit
2024-02-09,Myntra Shopping,Shopping,-5320,-6428230,Debit
2024-02-16,YouTube Premium,Entertainment,-9191,-6437421,Debit
2025-05-07,Medical Store,Health,-6378,-6443799,Debit
2024-10-15,Amazon Purchase,Shopping,-6679,-6450478,Debit
2024-05-16,Water Bill,Utilities,-522,-6451000,Debit
2024-10-29,Water Bill,Utilities,-1004,-6452004,Debit
2024-02-15,ATM Withdrawal,Cash,-6788,-6458792,Debit
2024-02-02,UPI to Friend,Transfer,-7754,-6466546,Debit
2025-04-29,Swiggy,Food,-3133,-6469679,Debit
2024-06-19,Freelance Payment,Income,4544,-6465135,Credit
2024-09-28,Interest Credit,Savings Interest,8991,-6456144,Credit
2024-08-02,Uber Ride,Transport,-3100,-6459244,Debit
2024-07-31,Internet Recharge,Utilities,-5372,-6464616,Debit
2025-04-23,Received from Rahul,Transfer,-9046,-6473662,Debit
2024-05-13,Electricity Bill,Utilities,-765,-6474427,Debit
2025-02-12,YouTube Premium,Entertainment,-890,-6475317,Debit
2025-05-05,UPI to Friend,Transfer,-7752,-6483069,Debit
2024-02-07,Petrol,Transport,-3633,-6486702,Debit
2024-04-17,Medical Store,Health,-3751,-6490453,Debit
2024-12-12,Medical Store,Health,-346,-6490799,Debit
2024-05-04,Train Ticket,Transport,-9714,-6500513,Debit
2024-07-13,Electricity Bill,Utilities,-7815,-6508328,Debit
2024-07-14,Amazon Purchase,Shopping,-1613,-6509941,Debit
2024-08-01,Myntra Shopping,Shopping,-4323,-6514264,Debit
2025-01-23,Electricity Bill,Utilities,-1693,-6515957,Debit
2024-05-14,FD Interest,Savings Interest,1930,-6514027,Credit
2024-09-18,Spotify,Entertainment,-1441,-6515468,Debit
2024-07-20,Water Bill,Utilities,-2721,-6518189,Debit
2024-02-28,Train Ticket,Transport,-5594,-6523783,Debit
2024-05-21,Myntra Shopping,Shopping,-582,-6524365,Debit
2024-06-13,FD Interest,Savings Interest,1224,-6523141,Credit
2024-08-22,YouTube Premium,Entertainment,-5356,-6528497,Debit
2024-12-31,Interest Credit,Savings Interest,10709,-6517788,Credit
2024-01-23,Swiggy,Food,-7141,-6524929,Debit
2024-01-26,Received from Rahul,Transfer,-4432,-6529361,Debit
2024-01-29,Bank Transfer,Transfer,-7693,-6537054,Debit
2025-01-28,Medical Store,Health,-3382,-6540436,Debit
2024-06-05,FD Interest,Savings Interest,1699,-6538737,Credit
2024-04-10,Internet Recharge,Utilities,-7197,-6545934,Debit
2024-08-19,FD Interest,Savings Interest,9731,-6536203,Credit
2024-06-23,Salary Credit,Income,8508,-6527695,Credit
2024-05-02,Doctor Visit,Health,-9685,-6537380,Debit
2024-07-19,YouTube Premium,Entertainment,-7732,-6545112,Debit
2025-03-20,Medical Store,Health,-3413,-6548525,Debit
2024-12-08,Petrol,Transport,-8296,-6556821,Debit
2025-01-11,Amazon Purchase,Shopping,-4613,-6561434,Debit
2024-04-05,Bank Transfer,Transfer,-5396,-6566830,Debit
2025-03-29,Bonus,Income,27240,-6539590,Credit
2024-11-13,Freelance Payment,Income,11788,-6527802,Credit
2025-02-06,Medical Store,Health,-9809,-6537611,Debit
2025-03-13,Cash Deposit,Cash,-5405,-6543016,Debit
2024-07-31,Uber Ride,Transport,-3852,-6546868,Debit
2025-03-30,Swiggy,Food,-7791,-6554659,Debit
2024-06-09,Restaurant Bill,Food,-5438,-6560097,Debit
2025-05-14,Internet Recharge,Utilities,-7328,-6567425,Debit
2025-04-15,Zomato Order,Food,-1779,-6569204,Debit
2024-07-21,Train Ticket,Transport,-3312,-6572516,Debit
2024-08-09,Train Ticket,Transport,-4611,-6577127,Debit
2024-08-06,ATM Withdrawal,Cash,-1484,-6578611,Debit
2024-12-08,Salary Credit,Income,6933,-6571678,Credit
2025-03-06,Bonus,Income,11478,-6560200,Credit
2024-11-11,Doctor Visit,Health,-7639,-6567839,Debit
2024-01-27,Movie Tickets,Entertainment,-3864,-6571703,Debit
2024-08-18,Water Bill,Utilities,-7955,-6579658,Debit
2025-04-12,YouTube Premium,Entertainment,-1986,-6581644,Debit
2024-12-17,Received from Rahul,Transfer,-4170,-6585814,Debit
2024-01-17,Myntra Shopping,Shopping,-5283,-6591097,Debit
2024-03-02,Flipkart Order,Shopping,-8032,-6599129,Debit
2024-03-14,Doctor Visit,Health,-3698,-6602827,Debit
2025-01-31,Cafe Coffee Day,Food,-7513,-6610340,Debit
2025-04-07,Received from Rahul,Transfer,-4416,-6614756,Debit
2024-04-30,Water Bill,Utilities,-5464,-6620220,Debit
2024-01-10,Medical Store,Health,-4430,-6624650,Debit
2024-02-03,Medical Store,Health,-6733,-6631383,Debit
2025-01-06,Swiggy,Food,-7528,-6638911,Debit
2025-01-29,Train Ticket,Transport,-5659,-6644570,Debit
2025-04-09,Freelance Payment,Income,20305,-6624265,Credit
2025-03-05,Petrol,Transport,-8719,-6632984,Debit
2024-03-15,Water Bill,Utilities,-121,-6633105,Debit
2024-09-08,Swiggy,Food,-1991,-6635096,Debit
2024-09-14,Interest Credit,Savings Interest,7648,-6627448,Credit
2024-06-10,Refund,Income,14314,-6613134,Credit
2024-10-19,Cash Deposit,Cash,-5023,-6618157,Debit
2024-08-18,Cash Deposit,Cash,-2957,-6621114,Debit
2024-03-16,Cafe Coffee Day,Food,-4287,-6625401,Debit
2024-12-03,Water Bill,Utilities,-727,-6626128,Debit
2024-06-06,ATM Withdrawal,Cash,-3464,-6629592,Debit
2024-01-15,Train Ticket,Transport,-5796,-6635388,Debit
2024-06-30,Bonus,Income,19916,-6615472,Credit
2025-01-04,Received from Rahul,Transfer,-2389,-6617861,Debit
2025-05-08,Water Bill,Utilities,-9885,-6627746,Debit
2024-04-28,Received from Rahul,Transfer,-9049,-6636795,Debit
2025-03-03,Flipkart Order,Shopping,-1835,-6638630,Debit
2024-08-06,Water Bill,Utilities,-7361,-6645991,Debit
2024-03-10,Restaurant Bill,Food,-2225,-6648216,Debit
2025-01-08,Movie Tickets,Entertainment,-8810,-6657026,Debit
2025-02-16,Electricity Bill,Utilities,-2469,-6659495,Debit
2025-04-10,Bonus,Income,15098,-6644397,Credit
2024-11-09,Received from Rahul,Transfer,-6565,-6650962,Debit
2024-06-09,Water Bill,Utilities,-7159,-6658121,Debit
2024-03-08,Swiggy,Food,-2170,-6660291,Debit
2024-12-16,Water Bill,Utilities,-9814,-6670105,Debit
2024-06-10,Interest Credit,Savings Interest,3754,-6666351,Credit
2025-02-22,Flipkart Order,Shopping,-3463,-6669814,Debit
2024-06-23,Cafe Coffee Day,Food,-3812,-6673626,Debit
2024-02-09,YouTube Premium,Entertainment,-2927,-6676553,Debit
2024-03-17,Medical Store,Health,-3702,-6680255,Debit
2024-03-01,Bonus,Income,3839,-6676416,Credit
2025-01-04,Freelance Payment,Income,13111,-6663305,Credit
2024-09-29,FD Interest,Savings Interest,16680,-6646625,Credit
2025-04-22,YouTube Premium,Entertainment,-4769,-6651394,Debit
2024-01-06,Amazon Purchase,Shopping,-8724,-6660118,Debit
2024-10-27,Salary Credit,Income,16447,-6643671,Credit
2024-08-11,Refund,Income,9350,-6634321,Credit
2025-01-13,Interest Credit,Savings Interest,16231,-6618090,Credit
2024-06-21,Internet Recharge,Utilities,-6131,-6624221,Debit
2024-11-13,Flipkart Order,Shopping,-7003,-6631224,Debit
2025-03-26,FD Interest,Savings Interest,27299,-6603925,Credit
2024-07-21,Train Ticket,Transport,-758,-6604683,Debit
2024-05-30,Interest Credit,Savings Interest,6822,-6597861,Credit
2024-02-20,Water Bill,Utilities,-8444,-6606305,Debit
2024-07-26,Cash Deposit,Cash,-9528,-6615833,Debit
2024-09-02,Restaurant Bill,Food,-6473,-6622306,Debit
2024-10-03,Cash Deposit,Cash,-8226,-6630532,Debit
2025-01-17,Flipkart Order,Shopping,-6552,-6637084,Debit
2024-04-30,FD Interest,Savings Interest,2568,-6634516,Credit
2024-06-09,Myntra Shopping,Shopping,-1488,-6636004,Debit
2024-05-27,Petrol,Transport,-5046,-6641050,Debit
2024-03-11,Petrol,Transport,-4758,-6645808,Debit
2024-10-20,Cafe Coffee Day,Food,-2903,-6648711,Debit
2024-04-09,Cash Deposit,Cash,-4241,-6652952,Debit
2025-03-18,Received from Rahul,Transfer,-9746,-6662698,Debit
2024-08-20,Cafe Coffee Day,Food,-907,-6663605,Debit
2024-09-20,Electricity Bill,Utilities,-4551,-6668156,Debit
2024-05-12,Electricity Bill,Utilities,-4332,-6672488,Debit
2024-03-08,Bank Transfer,Transfer,-5191,-6677679,Debit
2024-01-18,Petrol,Transport,-3748,-6681427,Debit
2025-02-14,Freelance Payment,Income,21800,-6659627,Credit
2024-03-10,Interest Credit,Savings Interest,4766,-6654861,Credit
2025-03-10,Cash Deposit,Cash,-6671,-6661532,Debit
2024-04-10,Bank Transfer,Transfer,-2165,-6663697,Debit
2024-01-03,Medical Store,Health,-5872,-6669569,Debit
2024-02-11,Interest Credit,Savings Interest,19606,-6649963,Credit
2024-09-24,Spotify,Entertainment,-9662,-6659625,Debit
2024-08-16,Refund,Income,6865,-6652760,Credit
2024-04-09,ATM Withdrawal,Cash,-5224,-6657984,Debit
2024-11-28,Amazon Purchase,Shopping,-5730,-6663714,Debit
2025-02-15,Electricity Bill,Utilities,-3347,-6667061,Debit
2025-03-23,Received from Rahul,Transfer,-5246,-6672307,Debit
2024-02-11,Refund,Income,5005,-6667302,Credit
2024-08-11,Uber Ride,Transport,-7672,-6674974,Debit
2024-11-07,Medical Store,Health,-6804,-6681778,Debit
2024-10-26,Amazon Purchase,Shopping,-9015,-6690793,Debit
2024-11-05,Bank Transfer,Transfer,-1918,-6692711,Debit
2024-05-06,Medical Store,Health,-5459,-6698170,Debit
2024-11-07,Uber Ride,Transport,-5446,-6703616,Debit
2024-06-14,Bank Transfer,Transfer,-1355,-6704971,Debit
2024-12-24,Interest Credit,Savings Interest,7573,-6697398,Credit
2025-04-26,Refund,Income,6475,-6690923,Credit
2024-03-15,Petrol,Transport,-1709,-6692632,Debit
2024-07-13,Salary Credit,Income,29746,-6662886,Credit
2025-01-24,Bank Transfer,Transfer,-4308,-6667194,Debit
2025-02-02,UPI to Friend,Transfer,-6744,-6673938,Debit
2024-10-28,Swiggy,Food,-5472,-6679410,Debit
2025-04-16,Bonus,Income,18007,-6661403,Credit
2025-02-19,Medical Store,Health,-3046,-6664449,Debit
2025-03-20,Cafe Coffee Day,Food,-893,-6665342,Debit
2024-11-29,Internet Recharge,Utilities,-7399,-6672741,Debit
2025-01-25,Medical Store,Health,-7301,-6680042,Debit
2024-08-12,ATM Withdrawal,Cash,-5979,-6686021,Debit
2025-04-21,Electricity Bill,Utilities,-6415,-6692436,Debit
2024-01-01,Internet Recharge,Utilities,-1475,-6693911,Debit
2025-05-05,Bonus,Income,7404,-6686507,Credit
2024-01-06,Uber Ride,Transport,-7840,-6694347,Debit
2024-08-23,Uber Ride,Transport,-5186,-6699533,Debit
2024-09-10,Medical Store,Health,-8750,-6708283,Debit
2024-12-24,UPI to Friend,Transfer,-9333,-6717616,Debit
2024-07-03,Spotify,Entertainment,-4060,-6721676,Debit
2024-04-23,Bank Transfer,Transfer,-1800,-6723476,Debit
2024-06-09,Uber Ride,Transport,-7928,-6731404,Debit
2024-07-25,Uber Ride,Transport,-9385,-6740789,Debit
2024-08-23,Bank Transfer,Transfer,-6808,-6747597,Debit
2024-07-25,Interest Credit,Savings Interest,11998,-6735599,Credit
2024-02-05,Myntra Shopping,Shopping,-5214,-6740813,Debit
2024-04-07,Cash Deposit,Cash,-6946,-6747759,Debit
2024-03-25,Amazon Purchase,Shopping,-5626,-6753385,Debit
2024-07-10,Medical Store,Health,-591,-6753976,Debit
2024-06-09,FD Interest,Savings Interest,23995,-6729981,Credit
2024-04-12,Electronics,Shopping,-7606,-6737587,Debit
2024-09-13,Cafe Coffee Day,Food,-7253,-6744840,Debit
2025-04-21,ATM Withdrawal,Cash,-922,-6745762,Debit
2024-06-07,Interest Credit,Savings Interest,13077,-6732685,Credit
2024-04-29,Electronics,Shopping,-818,-6733503,Debit
2024-04-13,Spotify,Entertainment,-5872,-6739375,Debit
2024-04-17,Cash Deposit,Cash,-5194,-6744569,Debit
2024-07-30,Uber Ride,Transport,-2174,-6746743,Debit
2025-01-16,Flipkart Order,Shopping,-9660,-6756403,Debit
2024-07-23,ATM Withdrawal,Cash,-6994,-6763397,Debit
2024-02-05,Petrol,Transport,-7351,-6770748,Debit
2024-02-03,Doctor Visit,Health,-5508,-6776256,Debit
2024-01-10,Medical Store,Health,-2752,-6779008,Debit
2024-01-06,YouTube Premium,Entertainment,-1313,-6780321,Debit
2024-01-07,Movie Tickets,Entertainment,-4097,-6784418,Debit
2025-01-02,FD Interest,Savings Interest,13935,-6770483,Credit
2024-05-09,Electricity Bill,Utilities,-7219,-6777702,Debit
2024-08-22,Movie Tickets,Entertainment,-5729,-6783431,Debit
2024-04-24,Salary Credit,Income,28276,-6755155,Credit
2024-05-21,FD Interest,Savings Interest,2616,-6752539,Credit
2025-04-21,Doctor Visit,Health,-6577,-6759116,Debit
2025-01-15,Freelance Payment,Income,23687,-6735429,Credit
2025-01-19,Bonus,Income,18706,-6716723,Credit
2024-07-14,Cash Deposit,Cash,-3164,-6719887,Debit
2024-01-06,Spotify,Entertainment,-7041,-6726928,Debit
2024-08-19,Amazon Purchase,Shopping,-2622,-6729550,Debit
2025-04-16,Spotify,Entertainment,-745,-6730295,Debit
2024-06-08,Swiggy,Food,-717,-6731012,Debit
2024-04-10,Electricity Bill,Utilities,-5319,-6736331,Debit
2024-04-06,Zomato Order,Food,-2203,-6738534,Debit
2024-07-08,Myntra Shopping,Shopping,-490,-6739024,Debit
2025-05-07,Bonus,Income,25451,-6713573,Credit
2024-04-11,Flipkart Order,Shopping,-5003,-6718576,Debit
2024-07-03,Medical Store,Health,-3767,-6722343,Debit
2024-05-09,Petrol,Transport,-2517,-6724860,Debit
2025-01-22,Bonus,Income,10615,-6714245,Credit
2024-09-30,Zomato Order,Food,-5320,-6719565,Debit
2025-05-06,Interest Credit,Savings Interest,17500,-6702065,Credit
2024-02-11,Myntra Shopping,Shopping,-3417,-6705482,Debit
2024-03-20,Bonus,Income,6645,-6698837,Credit
2025-03-05,Amazon Purchase,Shopping,-2926,-6701763,Debit
2024-05-28,Train Ticket,Transport,-3112,-6704875,Debit
2024-09-03,FD Interest,Savings Interest,18866,-6686009,Credit
2024-02-28,Salary Credit,Income,25568,-6660441,Credit
2024-01-04,YouTube Premium,Entertainment,-9610,-6670051,Debit
2025-03-09,Petrol,Transport,-2815,-6672866,Debit
2025-04-06,Amazon Purchase,Shopping,-4002,-6676868,Debit
2024-03-23,ATM Withdrawal,Cash,-2537,-6679405,Debit
2024-04-21,Medical Store,Health,-2550,-6681955,Debit
2025-04-07,UPI to Friend,Transfer,-7652,-6689607,Debit
2024-09-23,Cash Deposit,Cash,-2349,-6691956,Debit
2024-07-09,Petrol,Transport,-6843,-6698799,Debit
2024-08-12,Bonus,Income,17305,-6681494,Credit
2024-02-07,Uber Ride,Transport,-6718,-6688212,Debit
2024-06-24,Medical Store,Health,-5112,-6693324,Debit
2024-08-22,Myntra Shopping,Shopping,-5111,-6698435,Debit
2024-03-02,UPI to Friend,Transfer,-1912,-6700347,Debit
2025-05-07,Bonus,Income,24960,-6675387,Credit
2024-06-08,Internet Recharge,Utilities,-9489,-6684876,Debit
2024-10-05,FD Interest,Savings Interest,14158,-6670718,Credit
2024-09-15,ATM Withdrawal,Cash,-8796,-6679514,Debit
2024-02-16,Swiggy,Food,-3053,-6682567,Debit
2024-03-27,Myntra Shopping,Shopping,-3472,-6686039,Debit
2024-07-04,Uber Ride,Transport,-4675,-6690714,Debit
2024-08-02,Flipkart Order,Shopping,-9410,-6700124,Debit
2024-05-03,Swiggy,Food,-4435,-6704559,Debit
2024-08-20,Spotify,Entertainment,-6515,-6711074,Debit
2025-05-01,Medical Store,Health,-8480,-6719554,Debit
2025-04-03,Swiggy,Food,-5813,-6725367,Debit
2024-07-06,Petrol,Transport,-5247,-6730614,Debit
2024-04-14,Petrol,Transport,-8516,-6739130,Debit
2024-02-02,Swiggy,Food,-6260,-6745390,Debit
2025-03-15,FD Interest,Savings Interest,12485,-6732905,Credit
2024-12-27,Cafe Coffee Day,Food,-8332,-6741237,Debit
2025-03-27,Uber Ride,Transport,-4316,-6745553,Debit
2024-01-24,Water Bill,Utilities,-4002,-6749555,Debit
2024-04-23,Uber Ride,Transport,-5540,-6755095,Debit
2025-01-11,Water Bill,Utilities,-7866,-6762961,Debit
2024-11-05,Myntra Shopping,Shopping,-855,-6763816,Debit
2025-03-04,ATM Withdrawal,Cash,-9970,-6773786,Debit
2025-02-09,Cash Deposit,Cash,-1956,-6775742,Debit
2024-10-29,Freelance Payment,Income,13780,-6761962,Credit
2024-08-14,FD Interest,Savings Interest,27620,-6734342,Credit
2025-03-04,Swiggy,Food,-2241,-6736583,Debit
2025-04-07,Train Ticket,Transport,-9241,-6745824,Debit
2024-05-02,UPI to Friend,Transfer,-858,-6746682,Debit
2025-01-05,Restaurant Bill,Food,-1665,-6748347,Debit
2024-10-30,FD Interest,Savings Interest,26148,-6722199,Credit
2025-05-01,Movie Tickets,Entertainment,-407,-6722606,Debit
2024-04-03,Restaurant Bill,Food,-6934,-6729540,Debit
2024-08-01,Electronics,Shopping,-5197,-6734737,Debit
2024-02-27,Petrol,Transport,-2893,-6737630,Debit
2024-10-13,YouTube Premium,Entertainment,-5777,-6743407,Debit
2024-04-23,Doctor Visit,Health,-1883,-6745290,Debit
2024-02-07,Refund,Income,18597,-6726693,Credit
2024-04-29,Received from Rahul,Transfer,-2388,-6729081,Debit
2024-05-19,Swiggy,Food,-4903,-6733984,Debit
2025-04-03,Uber Ride,Transport,-1017,-6735001,Debit
2024-12-29,Doctor Visit,Health,-8413,-6743414,Debit
2025-04-20,ATM Withdrawal,Cash,-3981,-6747395,Debit
2025-01-29,Freelance Payment,Income,25805,-6721590,Credit
2024-10-21,YouTube Premium,Entertainment,-7331,-6728921,Debit
2024-10-18,Bonus,Income,21055,-6707866,Credit
2024-06-04,Cash Deposit,Cash,-7168,-6715034,Debit
2024-11-10,Uber Ride,Transport,-9658,-6724692,Debit
2024-04-29,Spotify,Entertainment,-1550,-6726242,Debit
2025-05-04,Bank Transfer,Transfer,-8852,-6735094,Debit
2024-07-25,Electricity Bill,Utilities,-8528,-6743622,Debit
2025-05-11,Cafe Coffee Day,Food,-1301,-6744923,Debit
2025-04-16,Cafe Coffee Day,Food,-692,-6745615,Debit
2024-11-07,Train Ticket,Transport,-1895,-6747510,Debit
2024-03-09,Amazon Purchase,Shopping,-5983,-6753493,Debit
2024-01-24,Zomato Order,Food,-4342,-6757835,Debit
2024-05-31,Freelance Payment,Income,20642,-6737193,Credit
2025-05-10,Uber Ride,Transport,-6430,-6743623,Debit
2024-01-08,YouTube Premium,Entertainment,-6397,-6750020,Debit
2025-03-12,ATM Withdrawal,Cash,-5132,-6755152,Debit
2024-03-02,Zomato Order,Food,-6460,-6761612,Debit
2025-03-26,Doctor Visit,Health,-5008,-6766620,Debit
2024-11-21,Uber Ride,Transport,-1212,-6767832,Debit
2025-04-10,Freelance Payment,Income,1001,-6766831,Credit
2024-02-29,Electronics,Shopping,-7238,-6774069,Debit
2024-11-10,Received from Rahul,Transfer,-3252,-6777321,Debit
2025-01-21,Refund,Income,4914,-6772407,Credit
2025-04-20,Electricity Bill,Utilities,-1124,-6773531,Debit
2024-04-11,ATM Withdrawal,Cash,-554,-6774085,Debit
2024-11-26,Received from Rahul,Transfer,-2514,-6776599,Debit
2025-02-08,Uber Ride,Transport,-4079,-6780678,Debit
2025-05-07,Cash Deposit,Cash,-9510,-6790188,Debit
2024-09-04,Spotify,Entertainment,-369,-6790557,Debit
2024-02-13,Doctor Visit,Health,-3522,-6794079,Debit
2024-11-05,Water Bill,Utilities,-8593,-6802672,Debit
2024-01-04,Cash Deposit,Cash,-1812,-6804484,Debit
2025-02-24,Salary Credit,Income,18407,-6786077,Credit
2025-01-23,Cash Deposit,Cash,-7639,-6793716,Debit
2025-03-30,YouTube Premium,Entertainment,-5767,-6799483,Debit
2024-07-13,Uber Ride,Transport,-3381,-6802864,Debit
2024-08-11,Uber Ride,Transport,-1224,-6804088,Debit
2025-04-13,Movie Tickets,Entertainment,-179,-6804267,Debit
2024-12-27,Amazon Purchase,Shopping,-466,-6804733,Debit
2024-03-08,Petrol,Transport,-3893,-6808626,Debit
2025-04-17,Electricity Bill,Utilities,-3797,-6812423,Debit
2024-03-30,Petrol,Transport,-7017,-6819440,Debit
2024-02-01,Uber Ride,Transport,-4817,-6824257,Debit
2024-02-05,Uber Ride,Transport,-8874,-6833131,Debit
2024-03-08,Cash Deposit,Cash,-4429,-6837560,Debit
2024-08-07,ATM Withdrawal,Cash,-3854,-6841414,Debit
2025-05-11,Swiggy,Food,-4120,-6845534,Debit
2024-11-26,Bank Transfer,Transfer,-3491,-6849025,Debit
2024-02-15,Received from Rahul,Transfer,-6261,-6855286,Debit
2024-09-17,UPI to Friend,Transfer,-8692,-6863978,Debit
2025-01-19,Internet Recharge,Utilities,-9618,-6873596,Debit
2024-09-27,Amazon Purchase,Shopping,-4186,-6877782,Debit
2025-05-11,Bank Transfer,Transfer,-7544,-6885326,Debit
2024-07-09,Bank Transfer,Transfer,-6123,-6891449,Debit
2024-10-10,Medical Store,Health,-7424,-6898873,Debit
2024-02-27,Myntra Shopping,Shopping,-2056,-6900929,Debit
2024-10-15,Medical Store,Health,-3082,-6904011,Debit
2024-05-20,Cafe Coffee Day,Food,-9650,-6913661,Debit
2024-02-11,Received from Rahul,Transfer,-4847,-6918508,Debit
2024-03-19,Restaurant Bill,Food,-5461,-6923969,Debit
2024-12-02,Electricity Bill,Utilities,-452,-6924421,Debit
2025-04-03,Spotify,Entertainment,-7439,-6931860,Debit
2025-02-04,Received from Rahul,Transfer,-7342,-6939202,Debit
2024-11-22,Amazon Purchase,Shopping,-7517,-6946719,Debit
2024-02-09,Medical Store,Health,-125,-6946844,Debit
2024-11-10,Electronics,Shopping,-406,-6947250,Debit
2024-07-17,Medical Store,Health,-2141,-6949391,Debit
2024-09-21,Restaurant Bill,Food,-9585,-6958976,Debit
2024-12-12,Restaurant Bill,Food,-7259,-6966235,Debit
2024-11-13,Swiggy,Food,-4507,-6970742,Debit
2024-03-29,Myntra Shopping,Shopping,-1439,-6972181,Debit
2024-06-04,Train Ticket,Transport,-1422,-6973603,Debit
2024-06-19,Bonus,Income,3185,-6970418,Credit
2025-01-04,Restaurant Bill,Food,-2051,-6972469,Debit
2024-01-20,Zomato Order,Food,-515,-6972984,Debit
2025-01-09,Zomato Order,Food,-6057,-6979041,Debit
2024-09-30,ATM Withdrawal,Cash,-3331,-6982372,Debit
2024-07-02,Cash Deposit,Cash,-5535,-6987907,Debit
2024-11-04,Spotify,Entertainment,-3444,-6991351,Debit
2024-09-02,ATM Withdrawal,Cash,-7275,-6998626,Debit
2024-12-10,ATM Withdrawal,Cash,-5871,-7004497,Debit
2024-09-11,FD Interest,Savings Interest,3934,-7000563,Credit
2025-02-05,Restaurant Bill,Food,-9183,-7009746,Debit
2025-01-31,Petrol,Transport,-7685,-7017431,Debit
2025-01-25,Refund,Income,7608,-7009823,Credit
2025-04-04,Cash Deposit,Cash,-2558,-7012381,Debit
2024-06-09,Cash Deposit,Cash,-8632,-7021013,Debit
2024-08-10,Doctor Visit,Health,-7783,-7028796,Debit
2024-10-04,Salary Credit,Income,1662,-7027134,Credit
2024-09-12,Zomato Order,Food,-9793,-7036927,Debit
2024-05-12,ATM Withdrawal,Cash,-1938,-7038865,Debit
2024-12-15,Petrol,Transport,-6259,-7045124,Debit
2025-03-23,Uber Ride,Transport,-3490,-7048614,Debit
2025-04-02,Myntra Shopping,Shopping,-2733,-7051347,Debit
2024-07-18,ATM Withdrawal,Cash,-4792,-7056139,Debit
2024-12-27,Cash Deposit,Cash,-1611,-7057750,Debit
2024-01-16,Refund,Income,1030,-7056720,Credit
2024-08-10,Cash Deposit,Cash,-6045,-7062765,Debit
2024-06-14,Interest Credit,Savings Interest,19807,-7042958,Credit
2024-11-16,Petrol,Transport,-8517,-7051475,Debit
2025-03-01,Electronics,Shopping,-307,-7051782,Debit
2024-04-06,Interest Credit,Savings Interest,12573,-7039209,Credit
2024-12-31,Uber Ride,Transport,-8354,-7047563,Debit
2024-02-10,Refund,Income,10984,-7036579,Credit
2024-03-15,UPI to Friend,Transfer,-383,-7036962,Debit
2024-07-20,Bank Transfer,Transfer,-2085,-7039047,Debit
2025-02-03,ATM Withdrawal,Cash,-6637,-7045684,Debit
2024-01-16,Electronics,Shopping,-455,-7046139,Debit
2024-10-20,Restaurant Bill,Food,-6031,-7052170,Debit
2024-10-06,Spotify,Entertainment,-6158,-7058328,Debit
2025-01-31,Zomato Order,Food,-9373,-7067701,Debit
2025-04-02,Restaurant Bill,Food,-1172,-7068873,Debit
2024-01-15,Train Ticket,Transport,-9457,-7078330,Debit
2024-09-15,Bank Transfer,Transfer,-9252,-7087582,Debit
2025-01-30,Flipkart Order,Shopping,-6139,-7093721,Debit
2025-02-25,Cash Deposit,Cash,-6430,-7100151,Debit
2025-04-16,Internet Recharge,Utilities,-1177,-7101328,Debit
2025-03-01,ATM Withdrawal,Cash,-5808,-7107136,Debit
2024-09-22,Interest Credit,Savings Interest,4222,-7102914,Credit
2024-05-09,Bank Transfer,Transfer,-8770,-7111684,Debit
2024-09-28,Zomato Order,Food,-1618,-7113302,Debit
2025-04-15,Electricity Bill,Utilities,-4827,-7118129,Debit
2024-09-28,Received from Rahul,Transfer,-4763,-7122892,Debit
2024-10-14,YouTube Premium,Entertainment,-637,-7123529,Debit
2025-03-16,Salary Credit,Income,22996,-7100533,Credit
2024-07-23,Spotify,Entertainment,-217,-7100750,Debit
2024-06-07,Doctor Visit,Health,-5909,-7106659,Debit
2024-10-15,Internet Recharge,Utilities,-5183,-7111842,Debit
2025-04-15,Bank Transfer,Transfer,-6824,-7118666,Debit
2024-11-13,Internet Recharge,Utilities,-2101,-7120767,Debit
2024-08-01,FD Interest,Savings Interest,4179,-7116588,Credit
2024-08-27,Interest Credit,Savings Interest,20542,-7096046,Credit
2024-11-15,Spotify,Entertainment,-3582,-7099628,Debit
2025-02-13,Petrol,Transport,-7525,-7107153,Debit
2025-02-03,Freelance Payment,Income,11850,-7095303,Credit
2024-04-20,Interest Credit,Savings Interest,12499,-7082804,Credit
2024-07-10,ATM Withdrawal,Cash,-7571,-7090375,Debit
2024-04-25,YouTube Premium,Entertainment,-8364,-7098739,Debit
2025-03-21,Movie Tickets,Entertainment,-4731,-7103470,Debit
2024-02-02,Cash Deposit,Cash,-1375,-7104845,Debit
2025-03-03,Amazon Purchase,Shopping,-2581,-7107426,Debit
2024-07-27,UPI to Friend,Transfer,-9740,-7117166,Debit
2024-05-23,Spotify,Entertainment,-1401,-7118567,Debit
2024-09-24,Doctor Visit,Health,-499,-7119066,Debit
2025-03-07,Bonus,Income,3512,-7115554,Credit
2024-09-28,Medical Store,Health,-5288,-7120842,Debit
2024-12-25,Myntra Shopping,Shopping,-4492,-7125334,Debit
2024-10-06,FD Interest,Savings Interest,29927,-7095407,Credit
2025-03-14,YouTube Premium,Entertainment,-1226,-7096633,Debit
2025-01-10,UPI to Friend,Transfer,-5145,-7101778,Debit
2025-02-21,Bank Transfer,Transfer,-2605,-7104383,Debit
2025-02-08,FD Interest,Savings Interest,17745,-7086638,Credit
2024-07-25,Bank Transfer,Transfer,-8418,-7095056,Debit
2025-04-06,Electricity Bill,Utilities,-493,-7095549,Debit
2024-05-23,Flipkart Order,Shopping,-6340,-7101889,Debit
2024-03-06,Cafe Coffee Day,Food,-1760,-7103649,Debit
2025-03-15,Electronics,Shopping,-7165,-7110814,Debit
2024-05-31,FD Interest,Savings Interest,21592,-7089222,Credit
2025-04-05,FD Interest,Savings Interest,22942,-7066280,Credit
2025-02-12,Interest Credit,Savings Interest,15390,-7050890,Credit
2025-03-23,Doctor Visit,Health,-6993,-7057883,Debit
2024-01-05,Spotify,Entertainment,-9577,-7067460,Debit
2024-01-04,Electronics,Shopping,-3492,-7070952,Debit
2024-12-29,Freelance Payment,Income,16188,-7054764,Credit
2024-02-26,Bonus,Income,26951,-7027813,Credit
2024-10-11,Cafe Coffee Day,Food,-3817,-7031630,Debit
2024-01-18,Movie Tickets,Entertainment,-5385,-7037015,Debit
2025-04-04,UPI to Friend,Transfer,-3649,-7040664,Debit
2024-10-31,Train Ticket,Transport,-2614,-7043278,Debit
2024-12-17,Cash Deposit,Cash,-6715,-7049993,Debit
2024-04-12,Medical Store,Health,-8417,-7058410,Debit
2024-10-14,Salary Credit,Income,1509,-7056901,Credit
2025-01-29,UPI to Friend,Transfer,-1120,-7058021,Debit
2024-07-28,ATM Withdrawal,Cash,-4950,-7062971,Debit
2024-09-21,Restaurant Bill,Food,-270,-7063241,Debit
2024-03-10,Zomato Order,Food,-6342,-7069583,Debit
2024-02-04,Received from Rahul,Transfer,-7610,-7077193,Debit
2025-01-12,Electricity Bill,Utilities,-3025,-7080218,Debit
2024-07-25,Train Ticket,Transport,-8651,-7088869,Debit
2024-11-15,Amazon Purchase,Shopping,-7946,-7096815,Debit
2024-10-10,Electricity Bill,Utilities,-2249,-7099064,Debit
2024-10-23,Amazon Purchase,Shopping,-9950,-7109014,Debit
2024-04-03,Uber Ride,Transport,-6282,-7115296,Debit
2024-01-05,Medical Store,Health,-4093,-7119389,Debit
2025-01-21,Refund,Income,11583,-7107806,Credit
2024-11-30,Restaurant Bill,Food,-9811,-7117617,Debit
2025-04-25,Bank Transfer,Transfer,-895,-7118512,Debit
2025-01-31,Cash Deposit,Cash,-3397,-7121909,Debit
2025-04-01,Refund,Income,17780,-7104129,Credit
2024-05-04,Amazon Purchase,Shopping,-5891,-7110020,Debit
2025-03-12,Cash Deposit,Cash,-2146,-7112166,Debit
2024-01-25,YouTube Premium,Entertainment,-4628,-7116794,Debit
2025-03-21,ATM Withdrawal,Cash,-4363,-7121157,Debit
2024-08-17,Electronics,Shopping,-2385,-7123542,Debit
2025-04-29,Electronics,Shopping,-8603,-7132145,Debit
2024-09-15,Internet Recharge,Utilities,-3046,-7135191,Debit
2024-11-19,Bank Transfer,Transfer,-5003,-7140194,Debit
2024-03-10,Restaurant Bill,Food,-1814,-7142008,Debit
2025-04-08,Doctor Visit,Health,-9974,-7151982,Debit
2024-03-25,Movie Tickets,Entertainment,-7477,-7159459,Debit
2025-02-28,Uber Ride,Transport,-785,-7160244,Debit
2024-12-19,Bank Transfer,Transfer,-4044,-7164288,Debit
2025-02-21,Electricity Bill,Utilities,-9501,-7173789,Debit
2024-03-13,Myntra Shopping,Shopping,-6843,-7180632,Debit
2025-04-15,Interest Credit,Savings Interest,28872,-7151760,Credit
2024-06-03,Swiggy,Food,-5191,-7156951,Debit
2025-03-28,Internet Recharge,Utilities,-7328,-7164279,Debit
2024-01-01,Doctor Visit,Health,-1103,-7165382,Debit
2024-11-23,Interest Credit,Savings Interest,18343,-7147039,Credit
2025-02-28,YouTube Premium,Entertainment,-4967,-7152006,Debit
2025-01-19,Interest Credit,Savings Interest,16453,-7135553,Credit
2024-06-13,Swiggy,Food,-4975,-7140528,Debit
2024-06-27,Cash Deposit,Cash,-164,-7140692,Debit
2024-07-26,Electronics,Shopping,-8727,-7149419,Debit
2024-07-19,Amazon Purchase,Shopping,-4004,-7153423,Debit
2024-01-03,Internet Recharge,Utilities,-842,-7154265,Debit
2024-09-27,Cafe Coffee Day,Food,-6921,-7161186,Debit
2025-02-13,Flipkart Order,Shopping,-4160,-7165346,Debit
2024-11-30,FD Interest,Savings Interest,17484,-7147862,Credit
2024-09-28,Petrol,Transport,-6669,-7154531,Debit
2025-02-15,Freelance Payment,Income,4490,-7150041,Credit
2025-05-13,Water Bill,Utilities,-6122,-7156163,Debit
2025-04-18,Interest Credit,Savings Interest,13655,-7142508,Credit
2024-11-29,UPI to Friend,Transfer,-3660,-7146168,Debit
2024-10-23,Cafe Coffee Day,Food,-3766,-7149934,Debit
2024-04-23,Train Ticket,Transport,-8818,-7158752,Debit
2024-05-04,Swiggy,Food,-920,-7159672,Debit
2025-01-13,Myntra Shopping,Shopping,-2655,-7162327,Debit
2024-11-01,Zomato Order,Food,-650,-7162977,Debit
2025-01-18,UPI to Friend,Transfer,-374,-7163351,Debit
2024-06-21,Medical Store,Health,-3378,-7166729,Debit
2025-04-02,Interest Credit,Savings Interest,19661,-7147068,Credit
2024-05-15,Doctor Visit,Health,-5044,-7152112,Debit
2024-01-16,UPI to Friend,Transfer,-9287,-7161399,Debit
2024-06-14,Zomato Order,Food,-8314,-7169713,Debit
2024-05-10,FD Interest,Savings Interest,1307,-7168406,Credit
2024-01-25,Cash Deposit,Cash,-8589,-7176995,Debit
2024-08-03,Zomato Order,Food,-2884,-7179879,Debit
2024-02-18,Cash Deposit,Cash,-1517,-7181396,Debit
2025-04-05,Doctor Visit,Health,-2476,-7183872,Debit
2024-11-30,YouTube Premium,Entertainment,-6382,-7190254,Debit
2024-09-12,Bank Transfer,Transfer,-5413,-7195667,Debit
2024-08-19,Electricity Bill,Utilities,-7816,-7203483,Debit
2024-04-12,Cafe Coffee Day,Food,-1980,-7205463,Debit
2024-07-28,Medical Store,Health,-8938,-7214401,Debit
2024-08-13,Train Ticket,Transport,-1076,-7215477,Debit
2025-04-16,Internet Recharge,Utilities,-6516,-7221993,Debit
2024-08-18,Flipkart Order,Shopping,-7072,-7229065,Debit
2024-09-07,Medical Store,Health,-8431,-7237496,Debit
2024-09-29,Flipkart Order,Shopping,-6177,-7243673,Debit
2024-07-26,Water Bill,Utilities,-3209,-7246882,Debit
2024-08-15,Received from Rahul,Transfer,-5573,-7252455,Debit
2024-07-06,Interest Credit,Savings Interest,29373,-7223082,Credit
2024-04-08,Uber Ride,Transport,-8236,-7231318,Debit
2024-10-08,Received from Rahul,Transfer,-9947,-7241265,Debit
2024-08-25,Electricity Bill,Utilities,-2920,-7244185,Debit
2024-01-04,Petrol,Transport,-4696,-7248881,Debit
2025-04-20,Amazon Purchase,Shopping,-5027,-7253908,Debit
2025-04-23,Received from Rahul,Transfer,-5084,-7258992,Debit
2024-04-16,Myntra Shopping,Shopping,-2331,-7261323,Debit
2024-05-31,Bonus,Income,26499,-7234824,Credit
2025-03-13,Myntra Shopping,Shopping,-2732,-7237556,Debit
2025-01-23,Doctor Visit,Health,-4389,-7241945,Debit
2025-01-01,Myntra Shopping,Shopping,-3246,-7245191,Debit
2024-09-06,Received from Rahul,Transfer,-286,-7245477,Debit
2024-03-30,Bank Transfer,Transfer,-1721,-7247198,Debit
2024-04-27,Electronics,Shopping,-6597,-7253795,Debit
2025-01-13,Internet Recharge,Utilities,-228,-7254023,Debit
2024-12-02,FD Interest,Savings Interest,9576,-7244447,Credit
2024-09-12,Electricity Bill,Utilities,-2060,-7246507,Debit
2025-03-22,Movie Tickets,Entertainment,-1827,-7248334,Debit
2025-04-05,Movie Tickets,Entertainment,-3848,-7252182,Debit
2024-11-16,Movie Tickets,Entertainment,-2825,-7255007,Debit
2025-04-19,Train Ticket,Transport,-780,-7255787,Debit
2024-06-18,Electricity Bill,Utilities,-569,-7256356,Debit
2024-07-04,Myntra Shopping,Shopping,-1041,-7257397,Debit
2024-02-02,Train Ticket,Transport,-9547,-7266944,Debit
2024-04-23,Received from Rahul,Transfer,-536,-7267480,Debit
2025-04-18,Petrol,Transport,-4425,-7271905,Debit
2024-03-13,Train Ticket,Transport,-1210,-7273115,Debit
2024-10-11,Interest Credit,Savings Interest,23906,-7249209,Credit
2025-03-08,Interest Credit,Savings Interest,8626,-7240583,Credit
2024-12-01,Interest Credit,Savings Interest,2417,-7238166,Credit
2024-05-27,Bank Transfer,Transfer,-831,-7238997,Debit
2025-02-08,Train Ticket,Transport,-580,-7239577,Debit
2025-04-26,Medical Store,Health,-2779,-7242356,Debit
2025-04-25,Received from Rahul,Transfer,-8680,-7251036,Debit
2024-03-06,Zomato Order,Food,-894,-7251930,Debit
2025-03-22,ATM Withdrawal,Cash,-6118,-7258048,Debit
2024-06-04,Freelance Payment,Income,3628,-7254420,Credit
2024-09-20,Bank Transfer,Transfer,-4778,-7259198,Debit
2024-05-09,ATM Withdrawal,Cash,-1757,-7260955,Debit
2025-02-22,Interest Credit,Savings Interest,13680,-7247275,Credit
2024-06-25,Salary Credit,Income,23086,-7224189,Credit
2024-04-13,YouTube Premium,Entertainment,-1133,-7225322,Debit
2024-03-06,Medical Store,Health,-611,-7225933,Debit
2025-03-10,Bonus,Income,22218,-7203715,Credit
2024-05-01,Bonus,Income,20072,-7183643,Credit
2024-04-28,Swiggy,Food,-5570,-7189213,Debit
2024-05-24,UPI to Friend,Transfer,-8037,-7197250,Debit
2024-05-10,Petrol,Transport,-9845,-7207095,Debit
2024-09-02,Spotify,Entertainment,-9054,-7216149,Debit
2024-01-19,Spotify,Entertainment,-8080,-7224229,Debit
2024-10-27,Flipkart Order,Shopping,-5282,-7229511,Debit
2024-02-01,Myntra Shopping,Shopping,-9267,-7238778,Debit
2025-01-18,Uber Ride,Transport,-797,-7239575,Debit
2025-02-23,Electricity Bill,Utilities,-4709,-7244284,Debit
2024-10-31,YouTube Premium,Entertainment,-4784,-7249068,Debit
2024-08-13,Interest Credit,Savings Interest,3711,-7245357,Credit
2025-01-02,Water Bill,Utilities,-4759,-7250116,Debit
2024-05-15,Zomato Order,Food,-1752,-7251868,Debit
2024-08-25,Myntra Shopping,Shopping,-5499,-7257367,Debit
2024-12-27,Bonus,Income,24377,-7232990,Credit
2024-04-18,Refund,Income,9314,-7223676,Credit
2024-10-11,Amazon Purchase,Shopping,-3799,-7227475,Debit
2024-02-26,ATM Withdrawal,Cash,-214,-7227689,Debit
2025-01-29,Uber Ride,Transport,-1399,-7229088,Debit
2024-01-16,UPI to Friend,Transfer,-1503,-7230591,Debit
2024-04-17,Train Ticket,Transport,-7150,-7237741,Debit
2024-02-04,Petrol,Transport,-9977,-7247718,Debit
2024-05-22,Amazon Purchase,Shopping,-952,-7248670,Debit
2025-03-03,Movie Tickets,Entertainment,-1290,-7249960,Debit
2024-02-27,Medical Store,Health,-8621,-7258581,Debit
2024-10-19,Bonus,Income,27212,-7231369,Credit
2024-04-12,Spotify,Entertainment,-5480,-7236849,Debit
2024-05-03,Swiggy,Food,-2776,-7239625,Debit
2024-10-19,Received from Rahul,Transfer,-1663,-7241288,Debit
2024-12-03,Petrol,Transport,-4424,-7245712,Debit
2025-02-20,FD Interest,Savings Interest,17328,-7228384,Credit
2024-08-31,YouTube Premium,Entertainment,-7809,-7236193,Debit
2024-03-27,YouTube Premium,Entertainment,-5170,-7241363,Debit
2024-11-25,Zomato Order,Food,-1131,-7242494,Debit
2025-04-20,UPI to Friend,Transfer,-5741,-7248235,Debit
2025-04-12,Zomato Order,Food,-5918,-7254153,Debit
2024-03-20,Zomato Order,Food,-8899,-7263052,Debit
2024-10-23,Petrol,Transport,-4109,-7267161,Debit
2024-05-10,Uber Ride,Transport,-2175,-7269336,Debit
2024-04-13,Salary Credit,Income,29155,-7240181,Credit
2024-01-30,Bonus,Income,6053,-7234128,Credit
2024-09-02,Refund,Income,27243,-7206885,Credit
2024-02-01,Doctor Visit,Health,-5986,-7212871,Debit
2024-07-26,Water Bill,Utilities,-1253,-7214124,Debit
2025-01-30,Freelance Payment,Income,12915,-7201209,Credit
2024-03-06,Doctor Visit,Health,-8879,-7210088,Debit
2024-06-04,Movie Tickets,Entertainment,-2200,-7212288,Debit
2024-09-18,Doctor Visit,Health,-9543,-7221831,Debit
2024-10-13,Medical Store,Health,-7517,-7229348,Debit
2024-12-08,Cash Deposit,Cash,-2452,-7231800,Debit
2025-05-13,Electronics,Shopping,-5209,-7237009,Debit
2024-11-11,Cash Deposit,Cash,-5547,-7242556,Debit
2024-02-06,Received from Rahul,Transfer,-7322,-7249878,Debit
2024-05-05,FD Interest,Savings Interest,27379,-7222499,Credit
2024-08-01,ATM Withdrawal,Cash,-972,-7223471,Debit
2025-04-17,Doctor Visit,Health,-5915,-7229386,Debit
2024-09-04,Bank Transfer,Transfer,-2493,-7231879,Debit
2024-01-12,Freelance Payment,Income,8868,-7223011,Credit
2024-08-19,Cash Deposit,Cash,-9103,-7232114,Debit
2024-11-23,ATM Withdrawal,Cash,-7516,-7239630,Debit
2024-07-22,ATM Withdrawal,Cash,-7344,-7246974,Debit
2025-03-15,Petrol,Transport,-3540,-7250514,Debit
2025-04-20,Medical Store,Health,-7566,-7258080,Debit
2024-02-02,Uber Ride,Transport,-5496,-7263576,Debit
2024-06-12,Cash Deposit,Cash,-7688,-7271264,Debit
2025-03-08,Medical Store,Health,-5604,-7276868,Debit
2024-03-04,Received from Rahul,Transfer,-2287,-7279155,Debit
2025-04-28,Swiggy,Food,-3900,-7283055,Debit
2025-03-02,Movie Tickets,Entertainment,-1366,-7284421,Debit
2024-06-03,Received from Rahul,Transfer,-6424,-7290845,Debit
2025-02-12,Bank Transfer,Transfer,-8323,-7299168,Debit
2024-07-10,Amazon Purchase,Shopping,-5968,-7305136,Debit
2024-03-08,YouTube Premium,Entertainment,-2021,-7307157,Debit
2024-08-29,Flipkart Order,Shopping,-1998,-7309155,Debit
2025-03-08,Cafe Coffee Day,Food,-8362,-7317517,Debit
2025-01-16,Swiggy,Food,-2188,-7319705,Debit
2024-01-23,Medical Store,Health,-4699,-7324404,Debit
2024-01-18,Train Ticket,Transport,-9072,-7333476,Debit
2024-11-17,Flipkart Order,Shopping,-6702,-7340178,Debit
2025-04-16,Petrol,Transport,-3534,-7343712,Debit
2024-03-11,YouTube Premium,Entertainment,-8894,-7352606,Debit
2025-01-29,Received from Rahul,Transfer,-9717,-7362323,Debit
2025-02-27,FD Interest,Savings Interest,9645,-7352678,Credit
2025-04-26,Electricity Bill,Utilities,-6741,-7359419,Debit
2024-05-22,Restaurant Bill,Food,-9861,-7369280,Debit
2024-09-18,ATM Withdrawal,Cash,-3308,-7372588,Debit
2025-04-01,Petrol,Transport,-164,-7372752,Debit
2024-05-04,Received from Rahul,Transfer,-7798,-7380550,Debit
2024-02-21,Interest Credit,Savings Interest,25880,-7354670,Credit
2024-12-09,Amazon Purchase,Shopping,-5410,-7360080,Debit
2024-12-12,Freelance Payment,Income,29981,-7330099,Credit
2024-12-19,Water Bill,Utilities,-6048,-7336147,Debit
2025-02-03,Electronics,Shopping,-4642,-7340789,Debit
2024-06-11,Electronics,Shopping,-8610,-7349399,Debit
2024-05-14,Electronics,Shopping,-5629,-7355028,Debit
2024-07-24,Uber Ride,Transport,-148,-7355176,Debit
2025-05-05,Petrol,Transport,-3335,-7358511,Debit
2025-04-03,FD Interest,Savings Interest,22507,-7336004,Credit
2024-07-01,Medical Store,Health,-1464,-7337468,Debit
2025-03-16,Flipkart Order,Shopping,-7708,-7345176,Debit
2024-01-02,Swiggy,Food,-9153,-7354329,Debit
2024-08-08,Refund,Income,19643,-7334686,Credit
2024-04-25,Interest Credit,Savings Interest,6864,-7327822,Credit
2024-08-15,Freelance Payment,Income,9501,-7318321,Credit
2024-04-29,Zomato Order,Food,-614,-7318935,Debit
2024-06-21,Bank Transfer,Transfer,-7186,-7326121,Debit
2024-10-14,Movie Tickets,Entertainment,-1115,-7327236,Debit
2025-03-29,FD Interest,Savings Interest,5558,-7321678,Credit
2024-06-07,YouTube Premium,Entertainment,-8516,-7330194,Debit
2024-12-02,Medical Store,Health,-7498,-7337692,Debit
2025-01-12,FD Interest,Savings Interest,24790,-7312902,Credit
2025-04-07,UPI to Friend,Transfer,-3841,-7316743,Debit
2025-02-05,UPI to Friend,Transfer,-5780,-7322523,Debit
2024-11-05,Movie Tickets,Entertainment,-5961,-7328484,Debit
2025-01-06,Freelance Payment,Income,6011,-7322473,Credit
2025-01-02,ATM Withdrawal,Cash,-2556,-7325029,Debit
2024-07-19,Uber Ride,Transport,-3148,-7328177,Debit
2025-02-10,Received from Rahul,Transfer,-2036,-7330213,Debit
2025-04-06,Medical Store,Health,-348,-7330561,Debit
2024-04-12,Doctor Visit,Health,-3909,-7334470,Debit
2024-11-09,Medical Store,Health,-3251,-7337721,Debit
2024-01-08,FD Interest,Savings Interest,8820,-7328901,Credit
2024-10-27,Movie Tickets,Entertainment,-1976,-7330877,Debit
2024-02-02,Uber Ride,Transport,-4565,-7335442,Debit
2024-02-18,Cash Deposit,Cash,-3934,-7339376,Debit
2024-06-30,Uber Ride,Transport,-1284,-7340660,Debit
2024-01-16,Electricity Bill,Utilities,-4921,-7345581,Debit
2024-07-26,UPI to Friend,Transfer,-550,-7346131,Debit
2025-02-16,Freelance Payment,Income,14652,-7331479,Credit
2024-10-10,Electricity Bill,Utilities,-6402,-7337881,Debit
2024-09-23,ATM Withdrawal,Cash,-2800,-7340681,Debit
2025-02-12,Movie Tickets,Entertainment,-1107,-7341788,Debit
2024-05-24,Uber Ride,Transport,-6155,-7347943,Debit
2024-11-20,Cafe Coffee Day,Food,-1767,-7349710,Debit
2024-01-08,Bonus,Income,11561,-7338149,Credit
2025-03-30,ATM Withdrawal,Cash,-3345,-7341494,Debit
2024-05-30,FD Interest,Savings Interest,25240,-7316254,Credit
2025-02-16,Doctor Visit,Health,-8410,-7324664,Debit
2024-05-21,Bank Transfer,Transfer,-6436,-7331100,Debit
2024-09-30,Electricity Bill,Utilities,-3773,-7334873,Debit
2024-11-02,Received from Rahul,Transfer,-817,-7335690,Debit
2025-04-07,FD Interest,Savings Interest,9609,-7326081,Credit
2025-02-04,Bank Transfer,Transfer,-7615,-7333696,Debit
2025-05-04,Bank Transfer,Transfer,-9603,-7343299,Debit
2025-02-08,Movie Tickets,Entertainment,-269,-7343568,Debit
2024-04-15,Bonus,Income,21600,-7321968,Credit
2024-09-29,Flipkart Order,Shopping,-6822,-7328790,Debit
2025-04-12,Electricity Bill,Utilities,-1732,-7330522,Debit
2024-07-22,Refund,Income,27244,-7303278,Credit
2024-12-01,Medical Store,Health,-2142,-7305420,Debit
2024-10-21,Restaurant Bill,Food,-2465,-7307885,Debit
2024-02-27,Interest Credit,Savings Interest,11712,-7296173,Credit
2025-02-05,Cash Deposit,Cash,-516,-7296689,Debit
2024-12-18,Water Bill,Utilities,-9354,-7306043,Debit
2025-01-04,FD Interest,Savings Interest,4143,-7301900,Credit
2024-05-31,Electricity Bill,Utilities,-2454,-7304354,Debit
2024-11-22,Movie Tickets,Entertainment,-3245,-7307599,Debit
2025-03-20,Internet Recharge,Utilities,-5372,-7312971,Debit
2024-12-10,Flipkart Order,Shopping,-406,-7313377,Debit
2025-03-12,Received from Rahul,Transfer,-3949,-7317326,Debit
2024-01-10,Internet Recharge,Utilities,-1098,-7318424,Debit
2024-05-26,Freelance Payment,Income,4337,-7314087,Credit
2024-12-24,Internet Recharge,Utilities,-1819,-7315906,Debit
2025-02-13,YouTube Premium,Entertainment,-6007,-7321913,Debit
2024-03-19,Internet Recharge,Utilities,-3723,-7325636,Debit
2024-12-06,Freelance Payment,Income,16509,-7309127,Credit
2024-08-05,Petrol,Transport,-8159,-7317286,Debit
2024-01-16,Spotify,Entertainment,-5487,-7322773,Debit
2024-09-03,Salary Credit,Income,28267,-7294506,Credit
2025-02-16,Interest Credit,Savings Interest,22760,-7271746,Credit
2024-03-14,Internet Recharge,Utilities,-8971,-7280717,Debit
2024-04-17,Medical Store,Health,-2019,-7282736,Debit
2024-07-19,YouTube Premium,Entertainment,-2050,-7284786,Debit
2024-04-26,Flipkart Order,Shopping,-694,-7285480,Debit
2024-10-23,Cash Deposit,Cash,-4607,-7290087,Debit
2024-05-18,Cash Deposit,Cash,-5783,-7295870,Debit
2024-10-19,Internet Recharge,Utilities,-111,-7295981,Debit
2024-11-11,Internet Recharge,Utilities,-8876,-7304857,Debit
2024-04-14,Salary Credit,Income,18211,-7286646,Credit
2024-02-03,Medical Store,Health,-6669,-7293315,Debit
2025-03-24,Zomato Order,Food,-6179,-7299494,Debit
2024-05-23,Uber Ride,Transport,-5744,-7305238,Debit
2025-01-25,Train Ticket,Transport,-2963,-7308201,Debit
2024-07-04,ATM Withdrawal,Cash,-9528,-7317729,Debit
2024-09-26,Spotify,Entertainment,-9300,-7327029,Debit
2024-01-21,ATM Withdrawal,Cash,-9858,-7336887,Debit
2024-05-31,YouTube Premium,Entertainment,-8339,-7345226,Debit
2024-05-05,Salary Credit,Income,2561,-7342665,Credit
2024-01-21,Water Bill,Utilities,-660,-7343325,Debit
2025-02-22,Salary Credit,Income,20513,-7322812,Credit
2024-08-03,Interest Credit,Savings Interest,8138,-7314674,Credit
2024-03-18,Medical Store,Health,-4476,-7319150,Debit
2024-10-29,Received from Rahul,Transfer,-5630,-7324780,Debit
2024-02-27,Swiggy,Food,-3533,-7328313,Debit
2025-05-09,Cash Deposit,Cash,-5263,-7333576,Debit
2024-03-13,Bank Transfer,Transfer,-6637,-7340213,Debit
2025-01-12,Electronics,Shopping,-4221,-7344434,Debit
2024-08-18,Myntra Shopping,Shopping,-6043,-7350477,Debit
2024-12-24,Electronics,Shopping,-1586,-7352063,Debit
2024-06-14,Petrol,Transport,-7959,-7360022,Debit
2024-08-28,Restaurant Bill,Food,-1788,-7361810,Debit
2024-05-23,Uber Ride,Transport,-1819,-7363629,Debit
2024-08-11,Spotify,Entertainment,-7819,-7371448,Debit
2025-04-09,Medical Store,Health,-6822,-7378270,Debit
2025-03-16,Movie Tickets,Entertainment,-1151,-7379421,Debit
2024-01-26,FD Interest,Savings Interest,14932,-7364489,Credit
2024-05-06,Uber Ride,Transport,-3802,-7368291,Debit
2025-01-02,Amazon Purchase,Shopping,-5211,-7373502,Debit
2024-03-23,Movie Tickets,Entertainment,-1999,-7375501,Debit
2024-03-15,ATM Withdrawal,Cash,-8045,-7383546,Debit
2025-05-12,Petrol,Transport,-8429,-7391975,Debit
2024-07-31,Internet Recharge,Utilities,-2731,-7394706,Debit
2025-04-13,Cafe Coffee Day,Food,-4808,-7399514,Debit
2024-04-06,Spotify,Entertainment,-4257,-7403771,Debit
2024-07-21,Electricity Bill,Utilities,-5560,-7409331,Debit
2025-03-26,Cash Deposit,Cash,-9718,-7419049,Debit
2025-05-11,Refund,Income,511,-7418538,Credit
2025-05-08,FD Interest,Savings Interest,28010,-7390528,Credit
2025-01-26,Bank Transfer,Transfer,-7071,-7397599,Debit
2024-04-01,Restaurant Bill,Food,-2585,-7400184,Debit
2024-03-02,Cash Deposit,Cash,-5065,-7405249,Debit
2024-09-04,FD Interest,Savings Interest,8996,-7396253,Credit
2025-03-05,Bank Transfer,Transfer,-4485,-7400738,Debit
2025-04-18,Interest Credit,Savings Interest,23351,-7377387,Credit
2024-05-08,Uber Ride,Transport,-8524,-7385911,Debit
2024-09-13,Train Ticket,Transport,-6303,-7392214,Debit
2024-04-22,Freelance Payment,Income,14667,-7377547,Credit
2024-11-16,Internet Recharge,Utilities,-4663,-7382210,Debit
2025-04-19,Received from Rahul,Transfer,-9246,-7391456,Debit
2024-05-25,Doctor Visit,Health,-3666,-7395122,Debit
2024-12-23,Medical Store,Health,-3452,-7398574,Debit
2024-06-02,Cash Deposit,Cash,-8399,-7406973,Debit
2024-02-27,Medical Store,Health,-414,-7407387,Debit
2025-02-19,Doctor Visit,Health,-8716,-7416103,Debit
2024-03-06,Myntra Shopping,Shopping,-4999,-7421102,Debit
2025-04-07,UPI to Friend,Transfer,-2576,-7423678,Debit
2024-11-03,Myntra Shopping,Shopping,-9446,-7433124,Debit
2025-01-20,Bank Transfer,Transfer,-7032,-7440156,Debit
2024-02-13,Water Bill,Utilities,-5537,-7445693,Debit
2024-12-18,Swiggy,Food,-934,-7446627,Debit
2024-10-02,Bonus,Income,10379,-7436248,Credit
2024-01-09,Medical Store,Health,-4944,-7441192,Debit
2025-02-01,Uber Ride,Transport,-4281,-7445473,Debit
2024-12-11,Received from Rahul,Transfer,-8717,-7454190,Debit
2025-03-23,Flipkart Order,Shopping,-8695,-7462885,Debit
2024-06-07,Interest Credit,Savings Interest,19386,-7443499,Credit
2024-10-08,Doctor Visit,Health,-7608,-7451107,Debit
2024-12-23,YouTube Premium,Entertainment,-5474,-7456581,Debit
2024-06-08,Electronics,Shopping,-9855,-7466436,Debit
2024-08-03,FD Interest,Savings Interest,4497,-7461939,Credit
2024-02-03,Swiggy,Food,-6404,-7468343,Debit
2024-09-19,Train Ticket,Transport,-683,-7469026,Debit
2024-01-19,Electronics,Shopping,-4515,-7473541,Debit
2024-10-19,Train Ticket,Transport,-9154,-7482695,Debit
2025-02-07,Movie Tickets,Entertainment,-5456,-7488151,Debit
2024-05-25,Received from Rahul,Transfer,-4014,-7492165,Debit
2024-03-24,Water Bill,Utilities,-8943,-7501108,Debit
2024-10-08,Bank Transfer,Transfer,-8500,-7509608,Debit
2025-02-25,Cash Deposit,Cash,-4695,-7514303,Debit
2024-12-07,Medical Store,Health,-4711,-7519014,Debit
2024-03-01,YouTube Premium,Entertainment,-5867,-7524881,Debit
2024-05-26,Water Bill,Utilities,-2670,-7527551,Debit
2025-05-04,YouTube Premium,Entertainment,-4169,-7531720,Debit
2024-01-16,YouTube Premium,Entertainment,-7095,-7538815,Debit
2024-06-15,Zomato Order,Food,-9705,-7548520,Debit
2025-02-26,Petrol,Transport,-1236,-7549756,Debit
2025-03-27,FD Interest,Savings Interest,4671,-7545085,Credit
2025-02-02,Swiggy,Food,-7494,-7552579,Debit
2025-04-06,YouTube Premium,Entertainment,-1530,-7554109,Debit
2024-08-13,Electricity Bill,Utilities,-7711,-7561820,Debit
2024-10-18,Interest Credit,Savings Interest,27728,-7534092,Credit
2024-03-11,Uber Ride,Transport,-3648,-7537740,Debit
2025-01-06,FD Interest,Savings Interest,15893,-7521847,Credit
2025-02-14,Water Bill,Utilities,-6645,-7528492,Debit
2024-06-07,FD Interest,Savings Interest,13677,-7514815,Credit
2024-10-07,Interest Credit,Savings Interest,14838,-7499977,Credit
2024-09-09,Internet Recharge,Utilities,-7726,-7507703,Debit
2025-05-10,UPI to Friend,Transfer,-495,-7508198,Debit
2024-06-03,Movie Tickets,Entertainment,-4647,-7512845,Debit
2024-03-27,Cash Deposit,Cash,-2566,-7515411,Debit
2024-08-25,FD Interest,Savings Interest,11780,-7503631,Credit
2024-06-20,Doctor Visit,Health,-1034,-7504665,Debit
2024-11-09,Movie Tickets,Entertainment,-4361,-7509026,Debit
2025-05-03,FD Interest,Savings Interest,5879,-7503147,Credit
2025-01-24,YouTube Premium,Entertainment,-8140,-7511287,Debit
2025-01-14,Interest Credit,Savings Interest,27744,-7483543,Credit
2024-09-11,Electronics,Shopping,-2605,-7486148,Debit
2024-09-09,Internet Recharge,Utilities,-4899,-7491047,Debit
2025-02-22,Petrol,Transport,-391,-7491438,Debit
2024-02-11,FD Interest,Savings Interest,21352,-7470086,Credit
2025-03-12,YouTube Premium,Entertainment,-9038,-7479124,Debit
2025-02-12,Interest Credit,Savings Interest,26158,-7452966,Credit
2024-06-06,FD Interest,Savings Interest,13640,-7439326,Credit
2025-02-10,Electronics,Shopping,-2292,-7441618,Debit
2024-02-14,Uber Ride,Transport,-442,-7442060,Debit
2024-03-10,Petrol,Transport,-2811,-7444871,Debit
2024-04-07,Medical Store,Health,-2200,-7447071,Debit
2025-03-25,Freelance Payment,Income,23650,-7423421,Credit
2024-04-16,Movie Tickets,Entertainment,-7487,-7430908,Debit
2025-05-12,YouTube Premium,Entertainment,-7454,-7438362,Debit
2025-03-20,Electricity Bill,Utilities,-2230,-7440592,Debit
2024-11-12,Petrol,Transport,-4999,-7445591,Debit
2024-11-23,Freelance Payment,Income,26355,-7419236,Credit
2024-01-10,Zomato Order,Food,-3569,-7422805,Debit
2025-01-05,Water Bill,Utilities,-7431,-7430236,Debit
2024-01-15,Movie Tickets,Entertainment,-1496,-7431732,Debit
2024-02-14,Medical Store,Health,-7331,-7439063,Debit
2024-02-09,Electronics,Shopping,-7627,-7446690,Debit
2025-01-19,Spotify,Entertainment,-8874,-7455564,Debit
2024-04-27,FD Interest,Savings Interest,5412,-7450152,Credit
2024-07-23,Zomato Order,Food,-2104,-7452256,Debit
2024-01-06,Zomato Order,Food,-7566,-7459822,Debit
2024-02-29,YouTube Premium,Entertainment,-1650,-7461472,Debit
2024-10-03,Swiggy,Food,-9478,-7470950,Debit
2024-02-18,Interest Credit,Savings Interest,27028,-7443922,Credit
2025-02-10,Bonus,Income,12651,-7431271,Credit
2024-11-06,Petrol,Transport,-1093,-7432364,Debit
2024-01-04,Doctor Visit,Health,-9327,-7441691,Debit
2024-07-20,Doctor Visit,Health,-7094,-7448785,Debit
2025-01-03,Water Bill,Utilities,-7801,-7456586,Debit
2024-04-12,Cash Deposit,Cash,-5960,-7462546,Debit
2024-02-17,Cash Deposit,Cash,-3327,-7465873,Debit
2024-09-12,Petrol,Transport,-9381,-7475254,Debit
2024-07-09,Electronics,Shopping,-7454,-7482708,Debit
2024-05-07,Doctor Visit,Health,-2233,-7484941,Debit
2024-02-07,Uber Ride,Transport,-7394,-7492335,Debit
2024-02-28,Bonus,Income,4563,-7487772,Credit
2024-04-24,Cafe Coffee Day,Food,-6632,-7494404,Debit
2024-01-03,Received from Rahul,Transfer,-4511,-7498915,Debit
2025-04-01,Freelance Payment,Income,5340,-7493575,Credit
2024-06-13,Flipkart Order,Shopping,-1828,-7495403,Debit
2025-01-26,FD Interest,Savings Interest,17081,-7478322,Credit
2025-04-09,Movie Tickets,Entertainment,-3162,-7481484,Debit
2024-04-01,Uber Ride,Transport,-4663,-7486147,Debit
2024-04-28,Amazon Purchase,Shopping,-2148,-7488295,Debit
2024-08-08,Uber Ride,Transport,-8947,-7497242,Debit
2025-04-08,Cafe Coffee Day,Food,-2718,-7499960,Debit
2024-02-13,Water Bill,Utilities,-3451,-7503411,Debit
2024-03-13,Bonus,Income,19044,-7484367,Credit
2025-01-28,YouTube Premium,Entertainment,-2254,-7486621,Debit
2025-02-09,Interest Credit,Savings Interest,17191,-7469430,Credit
2024-09-07,FD Interest,Savings Interest,13924,-7455506,Credit
2025-05-07,Cafe Coffee Day,Food,-3092,-7458598,Debit
2024-09-03,Bonus,Income,24545,-7434053,Credit
2024-07-20,Electricity Bill,Utilities,-5728,-7439781,Debit
2024-01-25,Medical Store,Health,-4684,-7444465,Debit
2024-11-28,Doctor Visit,Health,-570,-7445035,Debit
2024-11-17,Flipkart Order,Shopping,-5578,-7450613,Debit
2024-12-28,Electricity Bill,Utilities,-7659,-7458272,Debit
2024-04-13,Interest Credit,Savings Interest,24435,-7433837,Credit
2024-06-11,Interest Credit,Savings Interest,8761,-7425076,Credit
2024-11-13,Salary Credit,Income,19095,-7405981,Credit
2024-06-02,Salary Credit,Income,16229,-7389752,Credit
2024-06-25,Interest Credit,Savings Interest,21107,-7368645,Credit
2024-09-10,Uber Ride,Transport,-1303,-7369948,Debit
2025-02-22,Amazon Purchase,Shopping,-8520,-7378468,Debit
2025-05-13,Bank Transfer,Transfer,-8913,-7387381,Debit
2024-11-04,Cash Deposit,Cash,-9353,-7396734,Debit
2024-11-03,Refund,Income,2821,-7393913,Credit
2024-08-24,Train Ticket,Transport,-1205,-7395118,Debit
2025-04-30,ATM Withdrawal,Cash,-7402,-7402520,Debit
2024-01-23,Bonus,Income,2898,-7399622,Credit
2024-01-03,YouTube Premium,Entertainment,-5779,-7405401,Debit
2024-04-02,Cafe Coffee Day,Food,-1900,-7407301,Debit
2024-01-18,Uber Ride,Transport,-250,-7407551,Debit
2025-01-03,Amazon Purchase,Shopping,-5669,-7413220,Debit
2025-02-27,Doctor Visit,Health,-7188,-7420408,Debit
2024-12-07,Received from Rahul,Transfer,-6037,-7426445,Debit
2024-12-10,Swiggy,Food,-3448,-7429893,Debit
2024-05-11,Medical Store,Health,-6170,-7436063,Debit
2024-02-20,Cafe Coffee Day,Food,-3804,-7439867,Debit
2024-06-06,Received from Rahul,Transfer,-2411,-7442278,Debit
2024-06-29,Movie Tickets,Entertainment,-6824,-7449102,Debit
2024-09-17,Petrol,Transport,-1773,-7450875,Debit
2024-08-23,ATM Withdrawal,Cash,-883,-7451758,Debit
2024-09-22,Received from Rahul,Transfer,-5798,-7457556,Debit
2025-04-26,Swiggy,Food,-1684,-7459240,Debit
2024-12-22,Medical Store,Health,-5677,-7464917,Debit
2024-10-04,Medical Store,Health,-8426,-7473343,Debit
2024-10-09,Movie Tickets,Entertainment,-6742,-7480085,Debit
2024-05-09,Medical Store,Health,-529,-7480614,Debit
2024-03-09,Interest Credit,Savings Interest,27766,-7452848,Credit
2024-09-06,Interest Credit,Savings Interest,26374,-7426474,Credit
2024-01-12,YouTube Premium,Entertainment,-928,-7427402,Debit
2024-03-25,Interest Credit,Savings Interest,10691,-7416711,Credit
2024-01-27,Swiggy,Food,-625,-7417336,Debit
2024-02-01,Received from Rahul,Transfer,-5724,-7423060,Debit
2025-03-11,Spotify,Entertainment,-8389,-7431449,Debit
2025-05-12,Amazon Purchase,Shopping,-9109,-7440558,Debit
2025-04-14,Myntra Shopping,Shopping,-8318,-7448876,Debit
2024-01-22,Swiggy,Food,-3917,-7452793,Debit
2024-05-14,Movie Tickets,Entertainment,-6915,-7459708,Debit
2024-07-16,YouTube Premium,Entertainment,-5759,-7465467,Debit
2025-02-11,Bonus,Income,17788,-7447679,Credit
2024-10-01,Myntra Shopping,Shopping,-6136,-7453815,Debit
2025-02-20,Refund,Income,17793,-7436022,Credit
2024-04-29,FD Interest,Savings Interest,27100,-7408922,Credit
2024-04-26,Electricity Bill,Utilities,-4178,-7413100,Debit
2025-04-12,UPI to Friend,Transfer,-2367,-7415467,Debit
2024-02-08,Doctor Visit,Health,-1896,-7417363,Debit
2024-12-28,Zomato Order,Food,-6849,-7424212,Debit
2024-06-21,Salary Credit,Income,2332,-7421880,Credit
2024-10-14,Movie Tickets,Entertainment,-205,-7422085,Debit
2024-10-15,Refund,Income,4513,-7417572,Credit
2025-03-02,Movie Tickets,Entertainment,-4089,-7421661,Debit
2024-12-22,Bonus,Income,20621,-7401040,Credit
2024-12-08,Train Ticket,Transport,-3689,-7404729,Debit
2024-08-30,Myntra Shopping,Shopping,-7007,-7411736,Debit
2024-02-29,Uber Ride,Transport,-8858,-7420594,Debit
2024-04-11,ATM Withdrawal,Cash,-2711,-7423305,Debit
2024-11-18,Interest Credit,Savings Interest,10306,-7412999,Credit
2024-03-01,Train Ticket,Transport,-7447,-7420446,Debit
2025-01-18,Doctor Visit,Health,-566,-7421012,Debit
2024-07-09,ATM Withdrawal,Cash,-5477,-7426489,Debit
2024-08-13,YouTube Premium,Entertainment,-6576,-7433065,Debit
2024-07-29,Salary Credit,Income,10462,-7422603,Credit
2025-02-09,Train Ticket,Transport,-381,-7422984,Debit
2024-10-11,Water Bill,Utilities,-1632,-7424616,Debit
2025-02-04,Cash Deposit,Cash,-4302,-7428918,Debit
2025-03-21,Spotify,Entertainment,-7472,-7436390,Debit
2024-05-25,Cafe Coffee Day,Food,-3144,-7439534,Debit
2024-07-23,Cash Deposit,Cash,-7164,-7446698,Debit
2025-03-13,ATM Withdrawal,Cash,-778,-7447476,Debit
2024-12-26,Freelance Payment,Income,12466,-7435010,Credit
2025-02-18,Interest Credit,Savings Interest,7133,-7427877,Credit
2024-11-24,Flipkart Order,Shopping,-193,-7428070,Debit
2024-08-10,Doctor Visit,Health,-5168,-7433238,Debit
2024-02-25,Electricity Bill,Utilities,-5413,-7438651,Debit
2024-04-02,Cash Deposit,Cash,-4969,-7443620,Debit
2025-04-15,Spotify,Entertainment,-7866,-7451486,Debit
2024-07-11,Amazon Purchase,Shopping,-5616,-7457102,Debit
2024-02-07,UPI to Friend,Transfer,-6416,-7463518,Debit
2025-01-20,Doctor Visit,Health,-4251,-7467769,Debit
2024-08-27,Movie Tickets,Entertainment,-3051,-7470820,Debit
2024-01-15,Interest Credit,Savings Interest,7748,-7463072,Credit
2024-12-06,Cash Deposit,Cash,-8910,-7471982,Debit
2024-04-28,Uber Ride,Transport,-8042,-7480024,Debit
2025-05-02,Doctor Visit,Health,-9462,-7489486,Debit
2025-04-16,Cash Deposit,Cash,-4404,-7493890,Debit
2024-10-22,Myntra Shopping,Shopping,-4458,-7498348,Debit
2024-06-04,Myntra Shopping,Shopping,-1507,-7499855,Debit
2024-09-21,FD Interest,Savings Interest,18573,-7481282,Credit
2024-10-15,FD Interest,Savings Interest,7120,-7474162,Credit
2024-11-07,Cash Deposit,Cash,-4729,-7478891,Debit
2025-03-19,Cash Deposit,Cash,-2883,-7481774,Debit
2025-01-29,Water Bill,Utilities,-1606,-7483380,Debit
2024-04-28,Salary Credit,Income,11512,-7471868,Credit
2024-03-03,Myntra Shopping,Shopping,-5358,-7477226,Debit
2024-11-11,Salary Credit,Income,16232,-7460994,Credit
2025-05-02,Zomato Order,Food,-3437,-7464431,Debit
2024-01-27,Cash Deposit,Cash,-3949,-7468380,Debit
2024-05-20,Received from Rahul,Transfer,-2936,-7471316,Debit
2024-01-17,Electricity Bill,Utilities,-7394,-7478710,Debit
2025-03-06,Train Ticket,Transport,-9123,-7487833,Debit
2025-03-25,Medical Store,Health,-6838,-7494671,Debit
2024-05-03,FD Interest,Savings Interest,18751,-7475920,Credit
2024-02-26,Uber Ride,Transport,-6576,-7482496,Debit
2024-04-11,Bank Transfer,Transfer,-2727,-7485223,Debit
2025-02-15,UPI to Friend,Transfer,-320,-7485543,Debit
2025-01-05,Water Bill,Utilities,-6492,-7492035,Debit
2024-06-04,Internet Recharge,Utilities,-6663,-7498698,Debit
2024-12-15,Freelance Payment,Income,4298,-7494400,Credit
2024-09-05,Spotify,Entertainment,-527,-7494927,Debit
2024-05-31,ATM Withdrawal,Cash,-901,-7495828,Debit
2024-09-02,Doctor Visit,Health,-4598,-7500426,Debit
2024-04-29,Myntra Shopping,Shopping,-3310,-7503736,Debit
2024-07-30,Salary Credit,Income,28814,-7474922,Credit
2025-01-03,Medical Store,Health,-8493,-7483415,Debit
2024-05-28,Water Bill,Utilities,-7647,-7491062,Debit
2024-12-19,Medical Store,Health,-4306,-7495368,Debit
2024-05-23,ATM Withdrawal,Cash,-9051,-7504419,Debit
2024-10-05,Cafe Coffee Day,Food,-5190,-7509609,Debit
2025-02-15,Bonus,Income,18848,-7490761,Credit
2024-01-26,Water Bill,Utilities,-5222,-7495983,Debit
2024-06-24,Swiggy,Food,-1279,-7497262,Debit
2024-02-28,Bonus,Income,9787,-7487475,Credit
2024-10-01,Water Bill,Utilities,-8200,-7495675,Debit
2024-04-11,FD Interest,Savings Interest,22165,-7473510,Credit
2024-09-15,Freelance Payment,Income,13676,-7459834,Credit
2024-04-24,Spotify,Entertainment,-6483,-7466317,Debit
2025-04-13,Medical Store,Health,-8535,-7474852,Debit
2024-08-25,Water Bill,Utilities,-9334,-7484186,Debit
2024-07-08,Cash Deposit,Cash,-6111,-7490297,Debit
2025-03-14,ATM Withdrawal,Cash,-896,-7491193,Debit
2024-10-09,YouTube Premium,Entertainment,-5930,-7497123,Debit
2024-02-05,YouTube Premium,Entertainment,-5184,-7502307,Debit
2025-03-11,Salary Credit,Income,14011,-7488296,Credit
2024-10-06,YouTube Premium,Entertainment,-6552,-7494848,Debit
2025-02-25,Bonus,Income,9157,-7485691,Credit
2024-01-12,Refund,Income,9998,-7475693,Credit
2025-01-08,Electronics,Shopping,-4971,-7480664,Debit
2025-01-15,Electronics,Shopping,-7062,-7487726,Debit
2024-04-17,Refund,Income,4271,-7483455,Credit
2024-12-16,Bank Transfer,Transfer,-3669,-7487124,Debit
2024-09-21,Refund,Income,25287,-7461837,Credit
2024-09-08,Zomato Order,Food,-9339,-7471176,Debit
2024-09-15,Received from Rahul,Transfer,-4627,-7475803,Debit
2024-02-28,Medical Store,Health,-6255,-7482058,Debit
2025-03-12,UPI to Friend,Transfer,-9373,-7491431,Debit
2024-11-20,Swiggy,Food,-5068,-7496499,Debit
2024-03-19,Received from Rahul,Transfer,-8788,-7505287,Debit
2025-04-11,Myntra Shopping,Shopping,-5348,-7510635,Debit
2024-01-02,Electronics,Shopping,-3624,-7514259,Debit
2024-04-11,Bank Transfer,Transfer,-7004,-7521263,Debit
2024-04-03,Interest Credit,Savings Interest,6308,-7514955,Credit
2024-11-12,Salary Credit,Income,26863,-7488092,Credit
2024-06-25,Received from Rahul,Transfer,-4126,-7492218,Debit
2024-05-07,YouTube Premium,Entertainment,-3584,-7495802,Debit
2025-01-14,Medical Store,Health,-7370,-7503172,Debit
2024-02-09,Cafe Coffee Day,Food,-3100,-7506272,Debit
2024-07-29,Cash Deposit,Cash,-9539,-7515811,Debit
2025-01-24,Bonus,Income,14194,-7501617,Credit
2024-03-12,Water Bill,Utilities,-6472,-7508089,Debit
2024-06-24,Doctor Visit,Health,-778,-7508867,Debit
2024-10-16,Cafe Coffee Day,Food,-9703,-7518570,Debit
2025-03-02,ATM Withdrawal,Cash,-4611,-7523181,Debit
2024-08-04,Electronics,Shopping,-1509,-7524690,Debit
2024-07-24,Electricity Bill,Utilities,-4072,-7528762,Debit
2024-12-09,Flipkart Order,Shopping,-1936,-7530698,Debit
2024-08-13,Cash Deposit,Cash,-1830,-7532528,Debit
2024-03-16,Swiggy,Food,-6246,-7538774,Debit
2024-05-22,Petrol,Transport,-8494,-7547268,Debit
2024-09-05,UPI to Friend,Transfer,-6401,-7553669,Debit
2024-05-25,Electricity Bill,Utilities,-2728,-7556397,Debit
2025-02-22,Freelance Payment,Income,6224,-7550173,Credit
2025-01-08,UPI to Friend,Transfer,-6921,-7557094,Debit
2025-04-13,Petrol,Transport,-3298,-7560392,Debit
2024-08-19,Medical Store,Health,-4694,-7565086,Debit
2024-08-13,Cafe Coffee Day,Food,-8607,-7573693,Debit
2024-08-20,Water Bill,Utilities,-3135,-7576828,Debit
2025-05-05,ATM Withdrawal,Cash,-3503,-7580331,Debit
2024-04-05,YouTube Premium,Entertainment,-5655,-7585986,Debit
2024-10-24,Refund,Income,1708,-7584278,Credit
2025-04-02,Petrol,Transport,-6566,-7590844,Debit
2024-05-13,FD Interest,Savings Interest,15024,-7575820,Credit
2024-03-30,Bank Transfer,Transfer,-1342,-7577162,Debit
2024-11-23,Interest Credit,Savings Interest,19761,-7557401,Credit
2025-05-11,YouTube Premium,Entertainment,-5835,-7563236,Debit
2024-07-17,Spotify,Entertainment,-218,-7563454,Debit
2025-04-21,Interest Credit,Savings Interest,17506,-7545948,Credit
2025-05-03,Interest Credit,Savings Interest,28048,-7517900,Credit
2024-06-27,Cafe Coffee Day,Food,-9866,-7527766,Debit
2025-03-21,Doctor Visit,Health,-6097,-7533863,Debit
2024-04-26,YouTube Premium,Entertainment,-9048,-7542911,Debit
2024-02-11,UPI to Friend,Transfer,-2222,-7545133,Debit
2025-02-11,Spotify,Entertainment,-9013,-7554146,Debit
2025-04-02,Cafe Coffee Day,Food,-3808,-7557954,Debit
2024-07-28,FD Interest,Savings Interest,21016,-7536938,Credit
2024-03-29,Restaurant Bill,Food,-9967,-7546905,Debit
2024-05-14,Uber Ride,Transport,-7269,-7554174,Debit
2024-01-27,Received from Rahul,Transfer,-8779,-7562953,Debit
2024-03-24,Refund,Income,11072,-7551881,Credit
2024-05-06,Amazon Purchase,Shopping,-4309,-7556190,Debit
2025-02-11,Electricity Bill,Utilities,-3488,-7559678,Debit
2024-12-09,Bonus,Income,17985,-7541693,Credit
2025-02-06,Train Ticket,Transport,-6320,-7548013,Debit
2024-05-15,Medical Store,Health,-4975,-7552988,Debit
2024-09-14,ATM Withdrawal,Cash,-2627,-7555615,Debit
2024-07-31,Petrol,Transport,-3343,-7558958,Debit
2024-06-28,Train Ticket,Transport,-7794,-7566752,Debit
2024-06-20,Medical Store,Health,-8729,-7575481,Debit
2025-03-30,Restaurant Bill,Food,-2592,-7578073,Debit
2025-03-03,Zomato Order,Food,-4723,-7582796,Debit
2025-05-13,Uber Ride,Transport,-9537,-7592333,Debit
2024-09-11,Train Ticket,Transport,-3094,-7595427,Debit
2024-01-16,YouTube Premium,Entertainment,-3834,-7599261,Debit
2025-01-23,Internet Recharge,Utilities,-550,-7599811,Debit
2024-09-30,FD Interest,Savings Interest,27756,-7572055,Credit
2025-01-17,YouTube Premium,Entertainment,-9657,-7581712,Debit
2025-04-13,FD Interest,Savings Interest,28817,-7552895,Credit
2024-12-11,Water Bill,Utilities,-1303,-7554198,Debit
2024-04-13,Flipkart Order,Shopping,-9591,-7563789,Debit
2024-05-30,Bank Transfer,Transfer,-7267,-7571056,Debit
2024-08-08,Interest Credit,Savings Interest,22386,-7548670,Credit
2025-03-22,UPI to Friend,Transfer,-234,-7548904,Debit
2024-04-20,Doctor Visit,Health,-3880,-7552784,Debit
2024-12-05,Internet Recharge,Utilities,-6738,-7559522,Debit
2025-04-11,Cafe Coffee Day,Food,-3650,-7563172,Debit
2025-01-07,Petrol,Transport,-8067,-7571239,Debit
2025-01-03,Medical Store,Health,-7617,-7578856,Debit
2024-04-10,Flipkart Order,Shopping,-7988,-7586844,Debit
2025-02-17,Petrol,Transport,-5812,-7592656,Debit
2025-03-17,Internet Recharge,Utilities,-8320,-7600976,Debit
2025-01-03,Interest Credit,Savings Interest,6576,-7594400,Credit
2024-03-02,UPI to Friend,Transfer,-2150,-7596550,Debit
2025-02-17,Received from Rahul,Transfer,-9779,-7606329,Debit
2025-02-16,Interest Credit,Savings Interest,12229,-7594100,Credit
2024-03-11,Train Ticket,Transport,-174,-7594274,Debit
2024-01-03,Cash Deposit,Cash,-3327,-7597601,Debit
2024-06-10,Doctor Visit,Health,-3961,-7601562,Debit
2025-04-07,Medical Store,Health,-5103,-7606665,Debit
2025-02-10,Cash Deposit,Cash,-2536,-7609201,Debit
2024-04-15,UPI to Friend,Transfer,-4307,-7613508,Debit
2025-01-19,Electronics,Shopping,-7177,-7620685,Debit
2025-04-21,Flipkart Order,Shopping,-311,-7620996,Debit
2024-11-25,Spotify,Entertainment,-6847,-7627843,Debit
2024-01-06,Train Ticket,Transport,-3169,-7631012,Debit
2024-09-14,Movie Tickets,Entertainment,-348,-7631360,Debit
2024-08-08,Train Ticket,Transport,-2069,-7633429,Debit
2025-03-29,Refund,Income,6539,-7626890,Credit
2025-04-25,Electricity Bill,Utilities,-1850,-7628740,Debit
2024-08-23,Cash Deposit,Cash,-1058,-7629798,Debit
2025-03-25,Electronics,Shopping,-4738,-7634536,Debit
2024-12-08,Salary Credit,Income,17771,-7616765,Credit
2024-11-27,Received from Rahul,Transfer,-4464,-7621229,Debit
2025-01-18,Doctor Visit,Health,-8344,-7629573,Debit
2024-02-23,Received from Rahul,Transfer,-1957,-7631530,Debit
2024-12-09,Cash Deposit,Cash,-1339,-7632869,Debit
2025-05-12,Electricity Bill,Utilities,-1038,-7633907,Debit
2024-04-01,Freelance Payment,Income,1987,-7631920,Credit
2024-03-13,Amazon Purchase,Shopping,-9139,-7641059,Debit
2025-04-04,Restaurant Bill,Food,-8674,-7649733,Debit
2024-04-09,YouTube Premium,Entertainment,-6232,-7655965,Debit
2024-08-04,Swiggy,Food,-4643,-7660608,Debit
2024-09-27,Internet Recharge,Utilities,-1190,-7661798,Debit
2024-01-30,Medical Store,Health,-8511,-7670309,Debit
2025-01-03,Doctor Visit,Health,-5554,-7675863,Debit
2024-10-31,Medical Store,Health,-8246,-7684109,Debit
2024-12-08,Uber Ride,Transport,-9684,-7693793,Debit
2024-03-26,Internet Recharge,Utilities,-2237,-7696030,Debit
2024-10-11,Cash Deposit,Cash,-8686,-7704716,Debit
2025-03-07,Zomato Order,Food,-6122,-7710838,Debit
2024-10-17,Zomato Order,Food,-2671,-7713509,Debit
2024-03-23,Myntra Shopping,Shopping,-368,-7713877,Debit
2024-07-22,Petrol,Transport,-2970,-7716847,Debit
2025-01-12,Restaurant Bill,Food,-1974,-7718821,Debit
2025-01-15,Salary Credit,Income,4161,-7714660,Credit
2025-04-29,Salary Credit,Income,636,-7714024,Credit
2025-05-03,Zomato Order,Food,-879,-7714903,Debit
2024-04-20,Doctor Visit,Health,-1039,-7715942,Debit
2024-04-19,Electricity Bill,Utilities,-1952,-7717894,Debit
2025-01-06,Salary Credit,Income,8158,-7709736,Credit
2025-02-22,ATM Withdrawal,Cash,-3752,-7713488,Debit
2024-06-09,FD Interest,Savings Interest,27374,-7686114,Credit
2024-12-08,Refund,Income,965,-7685149,Credit
2024-10-29,Amazon Purchase,Shopping,-5278,-7690427,Debit
2025-03-25,Cafe Coffee Day,Food,-2210,-7692637,Debit
2024-12-05,Salary Credit,Income,11079,-7681558,Credit
2024-05-29,Uber Ride,Transport,-479,-7682037,Debit
2024-05-12,Flipkart Order,Shopping,-9760,-7691797,Debit
2024-07-12,Interest Credit,Savings Interest,25911,-7665886,Credit
2024-10-24,Received from Rahul,Transfer,-7077,-7672963,Debit
2024-08-04,Movie Tickets,Entertainment,-7397,-7680360,Debit
2025-02-24,Received from Rahul,Transfer,-9456,-7689816,Debit
2024-05-07,ATM Withdrawal,Cash,-9380,-7699196,Debit
2024-01-01,ATM Withdrawal,Cash,-1173,-7700369,Debit
2024-09-09,Received from Rahul,Transfer,-4583,-7704952,Debit
2024-06-06,Electricity Bill,Utilities,-6175,-7711127,Debit
2025-01-08,Doctor Visit,Health,-5096,-7716223,Debit
2024-09-25,Movie Tickets,Entertainment,-8362,-7724585,Debit
2024-03-15,Refund,Income,6890,-7717695,Credit
2024-09-27,YouTube Premium,Entertainment,-5262,-7722957,Debit
2024-10-02,Uber Ride,Transport,-5459,-7728416,Debit
2024-08-22,Doctor Visit,Health,-1737,-7730153,Debit
2025-01-21,Bonus,Income,12195,-7717958,Credit
2024-03-18,Doctor Visit,Health,-4194,-7722152,Debit
2024-10-01,Bank Transfer,Transfer,-915,-7723067,Debit
2024-10-25,Swiggy,Food,-7638,-7730705,Debit
2024-10-15,Interest Credit,Savings Interest,3117,-7727588,Credit
2025-04-06,Refund,Income,27482,-7700106,Credit
2024-11-09,Received from Rahul,Transfer,-6048,-7706154,Debit
2025-02-11,Electricity Bill,Utilities,-6321,-7712475,Debit
2024-09-12,UPI to Friend,Transfer,-2667,-7715142,Debit
2025-05-01,Petrol,Transport,-3321,-7718463,Debit
2024-02-22,Restaurant Bill,Food,-7471,-7725934,Debit
2024-06-12,ATM Withdrawal,Cash,-9963,-7735897,Debit
2024-05-06,Swiggy,Food,-636,-7736533,Debit
2024-06-18,Amazon Purchase,Shopping,-6089,-7742622,Debit
2024-12-20,Freelance Payment,Income,20635,-7721987,Credit
2025-03-09,Bank Transfer,Transfer,-3009,-7724996,Debit
2025-04-20,Electricity Bill,Utilities,-2195,-7727191,Debit
2024-07-13,ATM Withdrawal,Cash,-1061,-7728252,Debit
2024-06-25,Uber Ride,Transport,-9967,-7738219,Debit
2024-07-08,Electricity Bill,Utilities,-4260,-7742479,Debit
2024-10-17,Freelance Payment,Income,23708,-7718771,Credit
2024-08-22,Cafe Coffee Day,Food,-7067,-7725838,Debit
2024-01-17,Movie Tickets,Entertainment,-1862,-7727700,Debit
2024-11-15,ATM Withdrawal,Cash,-3501,-7731201,Debit
2024-09-24,Freelance Payment,Income,17450,-7713751,Credit
2024-08-08,Medical Store,Health,-9533,-7723284,Debit
2024-09-29,Amazon Purchase,Shopping,-8407,-7731691,Debit
2024-03-30,Bank Transfer,Transfer,-3511,-7735202,Debit
2024-12-21,Uber Ride,Transport,-3504,-7738706,Debit
2024-02-11,Cash Deposit,Cash,-5261,-7743967,Debit
2024-12-01,Doctor Visit,Health,-749,-7744716,Debit
2024-11-06,Water Bill,Utilities,-1885,-7746601,Debit
2024-10-01,FD Interest,Savings Interest,19482,-7727119,Credit
2025-01-21,Movie Tickets,Entertainment,-1306,-7728425,Debit
2024-04-06,Electronics,Shopping,-3117,-7731542,Debit
2025-04-20,Spotify,Entertainment,-6985,-7738527,Debit
2024-07-01,Flipkart Order,Shopping,-7422,-7745949,Debit
2024-07-21,Cash Deposit,Cash,-7017,-7752966,Debit
2024-02-10,Interest Credit,Savings Interest,2505,-7750461,Credit
2024-10-04,Cash Deposit,Cash,-3125,-7753586,Debit
2024-01-30,Freelance Payment,Income,17340,-7736246,Credit
2024-07-12,ATM Withdrawal,Cash,-9703,-7745949,Debit
2024-09-21,Cash Deposit,Cash,-3950,-7749899,Debit
2025-02-27,Bonus,Income,22923,-7726976,Credit
2024-03-18,Interest Credit,Savings Interest,23028,-7703948,Credit
2024-12-29,UPI to Friend,Transfer,-2579,-7706527,Debit
2024-03-04,Freelance Payment,Income,20761,-7685766,Credit
2024-11-22,Uber Ride,Transport,-9650,-7695416,Debit
2024-04-21,Internet Recharge,Utilities,-3914,-7699330,Debit
2024-12-17,Medical Store,Health,-6824,-7706154,Debit
2024-03-22,Spotify,Entertainment,-5855,-7712009,Debit
2024-06-08,FD Interest,Savings Interest,27590,-7684419,Credit
2025-02-15,Cash Deposit,Cash,-7969,-7692388,Debit
2024-04-19,Cash Deposit,Cash,-505,-7692893,Debit
2025-03-08,Interest Credit,Savings Interest,12229,-7680664,Credit
2024-08-09,Flipkart Order,Shopping,-1346,-7682010,Debit
2024-04-09,Medical Store,Health,-6422,-7688432,Debit
2024-04-09,Doctor Visit,Health,-7731,-7696163,Debit
2024-09-09,Uber Ride,Transport,-8430,-7704593,Debit
2024-03-18,ATM Withdrawal,Cash,-7297,-7711890,Debit
2024-02-20,ATM Withdrawal,Cash,-811,-7712701,Debit
2024-03-31,Restaurant Bill,Food,-4283,-7716984,Debit
2024-04-30,Spotify,Entertainment,-1459,-7718443,Debit
2024-09-14,Zomato Order,Food,-7455,-7725898,Debit
2025-03-15,ATM Withdrawal,Cash,-7649,-7733547,Debit
2024-08-31,Water Bill,Utilities,-4076,-7737623,Debit
2024-07-10,Train Ticket,Transport,-6498,-7744121,Debit
2024-06-15,Doctor Visit,Health,-8658,-7752779,Debit
2024-10-17,Interest Credit,Savings Interest,23608,-7729171,Credit
2025-03-09,Freelance Payment,Income,17273,-7711898,Credit
2024-09-02,Refund,Income,3295,-7708603,Credit
2024-01-01,Movie Tickets,Entertainment,-153,-7708756,Debit
2024-05-15,Cash Deposit,Cash,-3913,-7712669,Debit
2024-04-28,Cash Deposit,Cash,-9164,-7721833,Debit
2024-01-12,Train Ticket,Transport,-9761,-7731594,Debit
2024-12-12,ATM Withdrawal,Cash,-9127,-7740721,Debit
2025-01-06,YouTube Premium,Entertainment,-8865,-7749586,Debit
2024-04-11,YouTube Premium,Entertainment,-5981,-7755567,Debit
2025-01-29,Electronics,Shopping,-141,-7755708,Debit
2024-01-09,Movie Tickets,Entertainment,-4914,-7760622,Debit
2024-10-08,Restaurant Bill,Food,-6731,-7767353,Debit
2024-09-26,Amazon Purchase,Shopping,-5840,-7773193,Debit
2024-06-08,Internet Recharge,Utilities,-9298,-7782491,Debit
2024-01-24,Water Bill,Utilities,-906,-7783397,Debit
2024-01-24,Cash Deposit,Cash,-8729,-7792126,Debit
2024-03-11,Bonus,Income,17593,-7774533,Credit
2025-03-07,Doctor Visit,Health,-1839,-7776372,Debit
2024-06-27,Interest Credit,Savings Interest,20405,-7755967,Credit
2024-02-04,Internet Recharge,Utilities,-831,-7756798,Debit
2024-07-31,Amazon Purchase,Shopping,-1077,-7757875,Debit
2024-10-18,YouTube Premium,Entertainment,-1144,-7759019,Debit
2025-04-19,Bank Transfer,Transfer,-8659,-7767678,Debit
2024-01-02,Received from Rahul,Transfer,-2621,-7770299,Debit
2025-02-23,ATM Withdrawal,Cash,-6104,-7776403,Debit
2025-03-08,Salary Credit,Income,19731,-7756672,Credit
2025-01-14,FD Interest,Savings Interest,2626,-7754046,Credit
2024-07-25,Bank Transfer,Transfer,-3825,-7757871,Debit
2024-04-09,Cash Deposit,Cash,-4420,-7762291,Debit
2025-04-01,Salary Credit,Income,13320,-7748971,Credit
2025-04-18,ATM Withdrawal,Cash,-6941,-7755912,Debit
2024-10-19,Interest Credit,Savings Interest,15577,-7740335,Credit
2024-11-10,ATM Withdrawal,Cash,-5142,-7745477,Debit
2024-08-20,ATM Withdrawal,Cash,-243,-7745720,Debit
2024-02-14,Zomato Order,Food,-5572,-7751292,Debit
2024-04-03,Zomato Order,Food,-3695,-7754987,Debit
2025-01-04,Movie Tickets,Entertainment,-4054,-7759041,Debit
2024-09-08,Train Ticket,Transport,-4700,-7763741,Debit
2024-12-09,Freelance Payment,Income,732,-7763009,Credit
2025-05-08,YouTube Premium,Entertainment,-3378,-7766387,Debit
2025-03-06,Spotify,Entertainment,-2906,-7769293,Debit
2024-02-22,Freelance Payment,Income,7450,-7761843,Credit
2025-02-07,ATM Withdrawal,Cash,-6932,-7768775,Debit
2025-01-12,Doctor Visit,Health,-8264,-7777039,Debit
2024-10-31,Myntra Shopping,Shopping,-6885,-7783924,Debit
2024-09-25,ATM Withdrawal,Cash,-319,-7784243,Debit
2025-01-23,Movie Tickets,Entertainment,-5383,-7789626,Debit
2024-10-18,Zomato Order,Food,-1531,-7791157,Debit
2025-03-14,Water Bill,Utilities,-1758,-7792915,Debit
2025-03-02,YouTube Premium,Entertainment,-1273,-7794188,Debit
2024-08-06,Electricity Bill,Utilities,-2207,-7796395,Debit
2024-02-05,Freelance Payment,Income,13156,-7783239,Credit
2025-01-15,Internet Recharge,Utilities,-6942,-7790181,Debit
2024-07-22,FD Interest,Savings Interest,4167,-7786014,Credit
2025-02-28,Bonus,Income,7631,-7778383,Credit
2024-10-03,FD Interest,Savings Interest,2653,-7775730,Credit
2024-12-18,Myntra Shopping,Shopping,-4215,-7779945,Debit
2024-09-18,Petrol,Transport,-1754,-7781699,Debit
2025-01-07,YouTube Premium,Entertainment,-9814,-7791513,Debit
2024-05-10,Freelance Payment,Income,4224,-7787289,Credit
2024-12-05,Medical Store,Health,-1772,-7789061,Debit
2025-02-16,Electricity Bill,Utilities,-2505,-7791566,Debit
2024-06-06,Internet Recharge,Utilities,-8030,-7799596,Debit
2024-11-12,FD Interest,Savings Interest,16287,-7783309,Credit
2025-03-13,Received from Rahul,Transfer,-8975,-7792284,Debit
2025-03-05,Cash Deposit,Cash,-1609,-7793893,Debit
2025-02-12,Spotify,Entertainment,-9910,-7803803,Debit
2024-11-16,Freelance Payment,Income,9981,-7793822,Credit
2024-01-30,Bank Transfer,Transfer,-3856,-7797678,Debit
2025-02-01,Flipkart Order,Shopping,-9077,-7806755,Debit
2024-02-03,Movie Tickets,Entertainment,-886,-7807641,Debit
2024-05-12,FD Interest,Savings Interest,22837,-7784804,Credit
2025-05-05,Cafe Coffee Day,Food,-6577,-7791381,Debit
2024-02-17,Cafe Coffee Day,Food,-4910,-7796291,Debit
2025-01-18,Bonus,Income,5783,-7790508,Credit
2025-02-27,FD Interest,Savings Interest,24399,-7766109,Credit
2024-10-03,Amazon Purchase,Shopping,-7075,-7773184,Debit
2025-05-15,ATM Withdrawal,Cash,-5210,-7778394,Debit
2024-11-26,YouTube Premium,Entertainment,-4535,-7782929,Debit
2024-03-14,Electricity Bill,Utilities,-448,-7783377,Debit
2025-05-05,FD Interest,Savings Interest,29695,-7753682,Credit
2025-02-01,Interest Credit,Savings Interest,20674,-7733008,Credit
2024-03-08,Movie Tickets,Entertainment,-3623,-7736631,Debit
2024-10-23,ATM Withdrawal,Cash,-8488,-7745119,Debit
2024-11-17,Doctor Visit,Health,-8351,-7753470,Debit
2024-12-03,Flipkart Order,Shopping,-2015,-7755485,Debit
2024-04-25,Restaurant Bill,Food,-3986,-7759471,Debit
2024-06-06,FD Interest,Savings Interest,29207,-7730264,Credit
2025-01-02,UPI to Friend,Transfer,-9558,-7739822,Debit
2024-05-06,Medical Store,Health,-9072,-7748894,Debit
2025-01-05,Doctor Visit,Health,-2536,-7751430,Debit
2024-01-10,Petrol,Transport,-9000,-7760430,Debit
2024-11-23,YouTube Premium,Entertainment,-5117,-7765547,Debit
2024-09-29,FD Interest,Savings Interest,5499,-7760048,Credit
2024-04-11,Swiggy,Food,-4181,-7764229,Debit
2024-11-29,Interest Credit,Savings Interest,19079,-7745150,Credit
2024-05-11,Amazon Purchase,Shopping,-405,-7745555,Debit
2024-03-04,Received from Rahul,Transfer,-9773,-7755328,Debit
2024-07-17,Uber Ride,Transport,-8280,-7763608,Debit
2024-10-25,Spotify,Entertainment,-1074,-7764682,Debit
2024-09-13,Swiggy,Food,-2219,-7766901,Debit
2025-04-09,Interest Credit,Savings Interest,20454,-7746447,Credit
2024-09-28,UPI to Friend,Transfer,-8454,-7754901,Debit
2025-02-17,Uber Ride,Transport,-6353,-7761254,Debit
2024-06-06,Swiggy,Food,-5006,-7766260,Debit
2025-04-22,Spotify,Entertainment,-7272,-7773532,Debit
2024-04-11,YouTube Premium,Entertainment,-510,-7774042,Debit
2024-01-06,Refund,Income,7998,-7766044,Credit
2024-09-16,Flipkart Order,Shopping,-5445,-7771489,Debit
2024-12-11,Cash Deposit,Cash,-8886,-7780375,Debit
2024-02-08,Movie Tickets,Entertainment,-322,-7780697,Debit
2024-06-18,Zomato Order,Food,-2375,-7783072,Debit
2024-10-12,Spotify,Entertainment,-3193,-7786265,Debit
2024-10-09,Amazon Purchase,Shopping,-388,-7786653,Debit
2024-09-28,Spotify,Entertainment,-8000,-7794653,Debit
2025-03-24,Zomato Order,Food,-5051,-7799704,Debit
2024-06-30,YouTube Premium,Entertainment,-4294,-7803998,Debit
2024-08-01,Water Bill,Utilities,-9166,-7813164,Debit
2024-04-29,Medical Store,Health,-5440,-7818604,Debit
2025-02-04,Bank Transfer,Transfer,-8167,-7826771,Debit
2024-12-08,Bonus,Income,15589,-7811182,Credit
2024-02-03,Freelance Payment,Income,2550,-7808632,Credit
2025-04-17,FD Interest,Savings Interest,21070,-7787562,Credit
2024-05-02,Swiggy,Food,-8042,-7795604,Debit
2024-07-25,YouTube Premium,Entertainment,-3832,-7799436,Debit
2024-02-14,Cafe Coffee Day,Food,-5059,-7804495,Debit
2024-07-22,Electricity Bill,Utilities,-2122,-7806617,Debit
2024-02-13,Water Bill,Utilities,-9076,-7815693,Debit
2025-05-06,Train Ticket,Transport,-3011,-7818704,Debit
2024-03-11,Cash Deposit,Cash,-5131,-7823835,Debit
2024-04-09,Movie Tickets,Entertainment,-6263,-7830098,Debit
2025-04-05,ATM Withdrawal,Cash,-6066,-7836164,Debit
2025-03-03,Refund,Income,24864,-7811300,Credit
2024-02-18,Received from Rahul,Transfer,-3448,-7814748,Debit
2024-10-20,Interest Credit,Savings Interest,8279,-7806469,Credit
2024-05-04,ATM Withdrawal,Cash,-2491,-7808960,Debit
2024-12-31,Doctor Visit,Health,-5567,-7814527,Debit
2024-03-02,FD Interest,Savings Interest,3562,-7810965,Credit
2025-02-10,Spotify,Entertainment,-2465,-7813430,Debit
2024-03-30,Bank Transfer,Transfer,-7290,-7820720,Debit
2024-09-02,Interest Credit,Savings Interest,29631,-7791089,Credit
2024-02-21,Bonus,Income,29492,-7761597,Credit
2024-10-10,Water Bill,Utilities,-5055,-7766652,Debit
2024-05-03,Doctor Visit,Health,-1565,-7768217,Debit
2024-09-19,Flipkart Order,Shopping,-6874,-7775091,Debit
2024-03-11,Uber Ride,Transport,-5169,-7780260,Debit
2024-01-31,Received from Rahul,Transfer,-7452,-7787712,Debit
2025-01-05,Myntra Shopping,Shopping,-2976,-7790688,Debit
2025-02-27,Electronics,Shopping,-3497,-7794185,Debit
2024-02-20,Bonus,Income,6790,-7787395,Credit
2024-03-01,ATM Withdrawal,Cash,-9817,-7797212,Debit
2024-07-01,Amazon Purchase,Shopping,-430,-7797642,Debit
2024-03-19,Electricity Bill,Utilities,-6093,-7803735,Debit
2024-04-02,Doctor Visit,Health,-3403,-7807138,Debit
2024-06-13,Refund,Income,6049,-7801089,Credit
2024-04-30,Flipkart Order,Shopping,-9172,-7810261,Debit
2024-09-29,Swiggy,Food,-2242,-7812503,Debit
2024-01-11,Bank Transfer,Transfer,-997,-7813500,Debit
2024-06-06,Bank Transfer,Transfer,-4649,-7818149,Debit
2024-08-24,UPI to Friend,Transfer,-6633,-7824782,Debit
2024-02-12,Interest Credit,Savings Interest,23797,-7800985,Credit
2025-03-28,Spotify,Entertainment,-9392,-7810377,Debit
2024-02-26,Electricity Bill,Utilities,-6086,-7816463,Debit
2024-08-17,Internet Recharge,Utilities,-290,-7816753,Debit
2024-10-24,FD Interest,Savings Interest,26662,-7790091,Credit
2024-03-27,Doctor Visit,Health,-6827,-7796918,Debit
2024-06-23,Spotify,Entertainment,-1583,-7798501,Debit
2024-03-08,YouTube Premium,Entertainment,-145,-7798646,Debit
2024-07-10,ATM Withdrawal,Cash,-3707,-7802353,Debit
2024-01-21,Spotify,Entertainment,-6957,-7809310,Debit
2024-09-14,Swiggy,Food,-2540,-7811850,Debit
2024-02-20,ATM Withdrawal,Cash,-4081,-7815931,Debit
2025-02-21,YouTube Premium,Entertainment,-8980,-7824911,Debit
2024-10-22,Internet Recharge,Utilities,-7193,-7832104,Debit
2025-03-05,Medical Store,Health,-902,-7833006,Debit
2024-04-02,Electricity Bill,Utilities,-4389,-7837395,Debit
2025-02-20,Bonus,Income,12789,-7824606,Credit
2025-05-13,Cash Deposit,Cash,-234,-7824840,Debit
2025-03-12,Electricity Bill,Utilities,-942,-7825782,Debit
2024-01-04,UPI to Friend,Transfer,-7715,-7833497,Debit
2025-01-19,Myntra Shopping,Shopping,-8357,-7841854,Debit
2024-12-21,UPI to Friend,Transfer,-3227,-7845081,Debit
2025-02-26,Flipkart Order,Shopping,-9883,-7854964,Debit
2025-01-27,Train Ticket,Transport,-6747,-7861711,Debit
2024-12-24,Zomato Order,Food,-9393,-7871104,Debit
2024-06-14,Cash Deposit,Cash,-3225,-7874329,Debit
2025-01-13,Spotify,Entertainment,-2161,-7876490,Debit
2025-01-25,Electricity Bill,Utilities,-1327,-7877817,Debit
2024-02-01,ATM Withdrawal,Cash,-1207,-7879024,Debit
2024-06-19,Bonus,Income,7648,-7871376,Credit
2024-07-02,Petrol,Transport,-7732,-7879108,Debit
2024-05-08,Train Ticket,Transport,-9716,-7888824,Debit
2025-04-08,Refund,Income,15892,-7872932,Credit
2024-02-07,FD Interest,Savings Interest,11165,-7861767,Credit
2024-06-03,UPI to Friend,Transfer,-8395,-7870162,Debit
2025-02-11,Amazon Purchase,Shopping,-2722,-7872884,Debit
2024-01-24,ATM Withdrawal,Cash,-1837,-7874721,Debit
2024-08-07,UPI to Friend,Transfer,-9819,-7884540,Debit
2024-11-08,Movie Tickets,Entertainment,-4284,-7888824,Debit
2025-04-15,Doctor Visit,Health,-3254,-7892078,Debit
2024-05-20,Received from Rahul,Transfer,-9828,-7901906,Debit
2024-03-31,Medical Store,Health,-7559,-7909465,Debit
2024-05-19,Myntra Shopping,Shopping,-1773,-7911238,Debit
2024-07-30,Refund,Income,22956,-7888282,Credit
2025-01-31,Movie Tickets,Entertainment,-3576,-7891858,Debit
2024-06-21,Interest Credit,Savings Interest,5142,-7886716,Credit
2024-07-19,Doctor Visit,Health,-5152,-7891868,Debit
2024-02-26,Spotify,Entertainment,-4062,-7895930,Debit
2024-03-05,Medical Store,Health,-3036,-7898966,Debit
2024-10-19,Petrol,Transport,-667,-7899633,Debit
2025-04-16,Water Bill,Utilities,-6025,-7905658,Debit
2024-10-24,Zomato Order,Food,-396,-7906054,Debit
2024-05-25,ATM Withdrawal,Cash,-733,-7906787,Debit
2024-04-09,Bonus,Income,2258,-7904529,Credit
2024-03-21,Petrol,Transport,-1605,-7906134,Debit
2024-12-14,Restaurant Bill,Food,-2335,-7908469,Debit
2024-06-18,FD Interest,Savings Interest,4600,-7903869,Credit
2024-02-17,Zomato Order,Food,-9291,-7913160,Debit
2024-04-05,Restaurant Bill,Food,-8599,-7921759,Debit
2024-12-26,Medical Store,Health,-3195,-7924954,Debit
2024-05-11,Received from Rahul,Transfer,-3692,-7928646,Debit
2024-06-02,Zomato Order,Food,-6380,-7935026,Debit
2025-02-11,Electricity Bill,Utilities,-9860,-7944886,Debit
2025-02-04,Refund,Income,21161,-7923725,Credit
2024-08-23,Doctor Visit,Health,-3668,-7927393,Debit
2024-11-19,UPI to Friend,Transfer,-6872,-7934265,Debit
2024-06-29,FD Interest,Savings Interest,2037,-7932228,Credit
2024-12-29,UPI to Friend,Transfer,-5212,-7937440,Debit
2024-06-14,Zomato Order,Food,-7737,-7945177,Debit
2025-01-07,Swiggy,Food,-5363,-7950540,Debit
2024-10-20,YouTube Premium,Entertainment,-6008,-7956548,Debit
2025-05-02,Interest Credit,Savings Interest,11923,-7944625,Credit
2024-03-17,Restaurant Bill,Food,-9021,-7953646,Debit
2025-05-11,Zomato Order,Food,-2483,-7956129,Debit
2025-02-15,UPI to Friend,Transfer,-8187,-7964316,Debit
2024-12-29,Cafe Coffee Day,Food,-1266,-7965582,Debit
2024-02-19,Internet Recharge,Utilities,-7930,-7973512,Debit
2024-01-26,Medical Store,Health,-4671,-7978183,Debit
2024-05-02,Bonus,Income,25157,-7953026,Credit
2024-03-20,Train Ticket,Transport,-464,-7953490,Debit
2025-01-29,Electricity Bill,Utilities,-5040,-7958530,Debit
2025-04-26,Cafe Coffee Day,Food,-3776,-7962306,Debit
2024-09-18,Petrol,Transport,-1718,-7964024,Debit
2024-05-10,Salary Credit,Income,1480,-7962544,Credit
2024-05-05,Petrol,Transport,-6611,-7969155,Debit
2025-01-19,Bank Transfer,Transfer,-2092,-7971247,Debit
2025-03-03,FD Interest,Savings Interest,22849,-7948398,Credit
2024-08-16,FD Interest,Savings Interest,26581,-7921817,Credit
2024-04-06,Swiggy,Food,-8425,-7930242,Debit
2024-06-27,Bonus,Income,5270,-7924972,Credit
2024-03-15,Cash Deposit,Cash,-5090,-7930062,Debit
2024-06-01,Flipkart Order,Shopping,-4057,-7934119,Debit
2024-06-23,YouTube Premium,Entertainment,-3500,-7937619,Debit
2024-01-28,FD Interest,Savings Interest,20266,-7917353,Credit
2025-01-04,Water Bill,Utilities,-3165,-7920518,Debit
2024-11-01,Amazon Purchase,Shopping,-5501,-7926019,Debit
2024-04-10,Interest Credit,Savings Interest,9177,-7916842,Credit
2024-07-18,Train Ticket,Transport,-1166,-7918008,Debit
2024-07-20,Petrol,Transport,-4918,-7922926,Debit
2024-07-03,FD Interest,Savings Interest,5674,-7917252,Credit
2025-01-19,Petrol,Transport,-9624,-7926876,Debit
2025-05-02,Doctor Visit,Health,-909,-7927785,Debit
2024-10-01,Received from Rahul,Transfer,-2230,-7930015,Debit
2025-02-12,Amazon Purchase,Shopping,-9258,-7939273,Debit
2024-03-09,ATM Withdrawal,Cash,-9474,-7948747,Debit
2025-01-08,Spotify,Entertainment,-4739,-7953486,Debit
2025-02-03,Cafe Coffee Day,Food,-279,-7953765,Debit
2024-12-07,Medical Store,Health,-9375,-7963140,Debit
2024-02-25,Movie Tickets,Entertainment,-7649,-7970789,Debit
2025-02-11,Flipkart Order,Shopping,-703,-7971492,Debit
2024-09-27,Doctor Visit,Health,-5725,-7977217,Debit
2024-12-18,YouTube Premium,Entertainment,-8766,-7985983,Debit
2024-06-16,Salary Credit,Income,3669,-7982314,Credit
2024-02-10,Doctor Visit,Health,-8732,-7991046,Debit
2024-03-29,Received from Rahul,Transfer,-8250,-7999296,Debit
2024-06-30,Doctor Visit,Health,-5317,-8004613,Debit
2024-05-05,Myntra Shopping,Shopping,-605,-8005218,Debit
2025-04-03,Medical Store,Health,-1379,-8006597,Debit
2024-12-16,Movie Tickets,Entertainment,-8596,-8015193,Debit
2024-10-29,Bank Transfer,Transfer,-9368,-8024561,Debit
2024-07-23,Amazon Purchase,Shopping,-7850,-8032411,Debit
2024-12-05,Electronics,Shopping,-5367,-8037778,Debit
2025-05-09,ATM Withdrawal,Cash,-9236,-8047014,Debit
2024-06-11,Spotify,Entertainment,-2164,-8049178,Debit
2024-02-24,Restaurant Bill,Food,-6501,-8055679,Debit
2024-03-04,Doctor Visit,Health,-7428,-8063107,Debit
2025-04-03,FD Interest,Savings Interest,27990,-8035117,Credit
2024-06-04,Bonus,Income,17566,-8017551,Credit
2024-04-29,YouTube Premium,Entertainment,-7833,-8025384,Debit
2025-03-03,Bonus,Income,16797,-8008587,Credit
2025-03-15,ATM Withdrawal,Cash,-2818,-8011405,Debit
2025-01-22,Uber Ride,Transport,-562,-8011967,Debit
2024-04-18,Flipkart Order,Shopping,-6230,-8018197,Debit
2025-01-03,Flipkart Order,Shopping,-3260,-8021457,Debit
2024-02-14,FD Interest,Savings Interest,22125,-7999332,Credit
2024-04-16,ATM Withdrawal,Cash,-7704,-8007036,Debit
2024-06-28,Electricity Bill,Utilities,-6208,-8013244,Debit
2024-03-11,Freelance Payment,Income,6902,-8006342,Credit
2025-04-26,Restaurant Bill,Food,-9409,-8015751,Debit
2024-08-04,Swiggy,Food,-9654,-8025405,Debit
2024-12-23,Electricity Bill,Utilities,-419,-8025824,Debit
2025-03-28,Water Bill,Utilities,-2731,-8028555,Debit
2024-04-12,Cash Deposit,Cash,-9126,-8037681,Debit
2025-02-13,Uber Ride,Transport,-160,-8037841,Debit
2024-06-20,Received from Rahul,Transfer,-3804,-8041645,Debit
2024-10-14,Cash Deposit,Cash,-2547,-8044192,Debit
2024-06-11,Flipkart Order,Shopping,-3798,-8047990,Debit
2024-07-28,Doctor Visit,Health,-4554,-8052544,Debit
2025-05-06,Myntra Shopping,Shopping,-3095,-8055639,Debit
2025-01-25,Water Bill,Utilities,-3963,-8059602,Debit
2024-06-10,ATM Withdrawal,Cash,-3233,-8062835,Debit
2024-12-23,Petrol,Transport,-4779,-8067614,Debit
2024-11-14,FD Interest,Savings Interest,15067,-8052547,Credit
2024-03-04,Bonus,Income,12370,-8040177,Credit
2024-06-30,Electronics,Shopping,-1494,-8041671,Debit
2024-11-21,Salary Credit,Income,2979,-8038692,Credit
2024-02-11,ATM Withdrawal,Cash,-3841,-8042533,Debit
2024-08-17,YouTube Premium,Entertainment,-7329,-8049862,Debit
2024-09-02,Spotify,Entertainment,-2965,-8052827,Debit
2024-10-11,Doctor Visit,Health,-2021,-8054848,Debit
2024-10-28,Medical Store,Health,-3103,-8057951,Debit
2024-10-23,Swiggy,Food,-201,-8058152,Debit
2024-07-19,Freelance Payment,Income,15074,-8043078,Credit
2024-04-03,Internet Recharge,Utilities,-3995,-8047073,Debit
2024-02-19,Train Ticket,Transport,-775,-8047848,Debit
2024-11-15,Amazon Purchase,Shopping,-2082,-8049930,Debit
2025-04-27,Movie Tickets,Entertainment,-947,-8050877,Debit
2024-01-08,Salary Credit,Income,9693,-8041184,Credit
2025-05-10,Received from Rahul,Transfer,-6175,-8047359,Debit
2025-03-13,Interest Credit,Savings Interest,8774,-8038585,Credit
2024-06-03,Train Ticket,Transport,-3323,-8041908,Debit
2025-01-30,UPI to Friend,Transfer,-3827,-8045735,Debit
2024-05-04,Received from Rahul,Transfer,-336,-8046071,Debit
2025-02-03,Doctor Visit,Health,-619,-8046690,Debit
2024-05-26,Electricity Bill,Utilities,-9535,-8056225,Debit
2024-02-17,Water Bill,Utilities,-7725,-8063950,Debit
2025-03-30,ATM Withdrawal,Cash,-9712,-8073662,Debit
2024-10-06,Zomato Order,Food,-4195,-8077857,Debit
2024-06-30,Electricity Bill,Utilities,-4407,-8082264,Debit
2024-08-09,Movie Tickets,Entertainment,-2153,-8084417,Debit
2024-03-15,Cash Deposit,Cash,-2030,-8086447,Debit
2025-05-02,UPI to Friend,Transfer,-9168,-8095615,Debit
2024-01-08,Swiggy,Food,-7257,-8102872,Debit
2024-04-20,ATM Withdrawal,Cash,-4329,-8107201,Debit
2024-10-04,Cash Deposit,Cash,-2393,-8109594,Debit
2025-04-13,Water Bill,Utilities,-1360,-8110954,Debit
2025-01-10,Petrol,Transport,-2183,-8113137,Debit
2024-02-19,Swiggy,Food,-4726,-8117863,Debit
2024-04-29,Uber Ride,Transport,-6079,-8123942,Debit
2024-10-22,Interest Credit,Savings Interest,7391,-8116551,Credit
2025-02-05,Electricity Bill,Utilities,-3952,-8120503,Debit
2024-01-21,Uber Ride,Transport,-1643,-8122146,Debit
2024-03-04,Freelance Payment,Income,21954,-8100192,Credit
2024-07-04,Cafe Coffee Day,Food,-5063,-8105255,Debit
2024-05-20,Electricity Bill,Utilities,-7092,-8112347,Debit
2025-03-24,Bonus,Income,21994,-8090353,Credit
2024-05-20,Refund,Income,24758,-8065595,Credit
2025-03-31,Interest Credit,Savings Interest,16679,-8048916,Credit
2024-01-10,Internet Recharge,Utilities,-8488,-8057404,Debit
2025-01-18,Cash Deposit,Cash,-1125,-8058529,Debit
2024-01-02,ATM Withdrawal,Cash,-5704,-8064233,Debit
2024-06-04,Electricity Bill,Utilities,-4193,-8068426,Debit
2025-01-28,Doctor Visit,Health,-9621,-8078047,Debit
2024-06-03,Zomato Order,Food,-9813,-8087860,Debit
2024-07-08,Restaurant Bill,Food,-6347,-8094207,Debit
2024-02-27,Internet Recharge,Utilities,-4586,-8098793,Debit
2024-10-15,FD Interest,Savings Interest,19314,-8079479,Credit
2025-03-11,Cash Deposit,Cash,-3497,-8082976,Debit
2024-07-10,Doctor Visit,Health,-8692,-8091668,Debit
2025-04-14,Spotify,Entertainment,-6420,-8098088,Debit
2025-03-30,Received from Rahul,Transfer,-2085,-8100173,Debit
2024-10-03,Zomato Order,Food,-1393,-8101566,Debit
2024-02-09,Cafe Coffee Day,Food,-6390,-8107956,Debit
2024-10-24,Uber Ride,Transport,-1378,-8109334,Debit
2024-08-05,Medical Store,Health,-9137,-8118471,Debit
2024-05-11,Electronics,Shopping,-4108,-8122579,Debit
2024-11-05,Electricity Bill,Utilities,-6011,-8128590,Debit
2024-03-21,UPI to Friend,Transfer,-1413,-8130003,Debit
2024-07-08,Interest Credit,Savings Interest,9630,-8120373,Credit
2024-09-07,Internet Recharge,Utilities,-3729,-8124102,Debit
2024-05-07,Flipkart Order,Shopping,-4368,-8128470,Debit
2025-01-16,Cafe Coffee Day,Food,-8531,-8137001,Debit
2024-07-31,YouTube Premium,Entertainment,-702,-8137703,Debit
2024-11-23,Flipkart Order,Shopping,-119,-8137822,Debit
2024-10-27,Refund,Income,19888,-8117934,Credit
2024-07-08,Bonus,Income,22358,-8095576,Credit
2025-03-17,Received from Rahul,Transfer,-2947,-8098523,Debit
2024-11-08,Uber Ride,Transport,-840,-8099363,Debit
2024-03-23,Swiggy,Food,-7941,-8107304,Debit
2024-01-10,Cafe Coffee Day,Food,-9686,-8116990,Debit
2024-10-03,Bonus,Income,11241,-8105749,Credit
2024-06-17,UPI to Friend,Transfer,-4085,-8109834,Debit
2024-01-03,ATM Withdrawal,Cash,-2670,-8112504,Debit
2025-04-16,Internet Recharge,Utilities,-7855,-8120359,Debit
2025-03-07,FD Interest,Savings Interest,6152,-8114207,Credit
2024-01-23,Bank Transfer,Transfer,-2281,-8116488,Debit
2024-02-15,Movie Tickets,Entertainment,-9693,-8126181,Debit
2024-05-25,Received from Rahul,Transfer,-7829,-8134010,Debit
2024-01-12,Petrol,Transport,-8237,-8142247,Debit
2024-10-20,Interest Credit,Savings Interest,27272,-8114975,Credit
2025-04-16,Doctor Visit,Health,-7212,-8122187,Debit
2025-04-08,Doctor Visit,Health,-2922,-8125109,Debit
2025-02-27,Myntra Shopping,Shopping,-3338,-8128447,Debit
2024-04-12,Train Ticket,Transport,-4368,-8132815,Debit
2025-01-18,Medical Store,Health,-7029,-8139844,Debit
2024-07-28,Flipkart Order,Shopping,-2090,-8141934,Debit
2024-11-19,ATM Withdrawal,Cash,-1838,-8143772,Debit
2024-05-25,UPI to Friend,Transfer,-3358,-8147130,Debit
2024-04-06,Spotify,Entertainment,-1936,-8149066,Debit
2024-08-13,Flipkart Order,Shopping,-7604,-8156670,Debit
2024-02-06,Spotify,Entertainment,-1531,-8158201,Debit
2024-08-11,Myntra Shopping,Shopping,-1164,-8159365,Debit
2025-03-28,FD Interest,Savings Interest,26048,-8133317,Credit
2024-10-10,Train Ticket,Transport,-7614,-8140931,Debit
2024-06-02,Flipkart Order,Shopping,-1287,-8142218,Debit
2024-06-12,Refund,Income,26884,-8115334,Credit
2024-03-28,Cafe Coffee Day,Food,-7014,-8122348,Debit
2024-12-15,Movie Tickets,Entertainment,-7766,-8130114,Debit
2024-01-20,Interest Credit,Savings Interest,5037,-8125077,Credit
2024-05-15,Electricity Bill,Utilities,-9011,-8134088,Debit
2024-06-02,Swiggy,Food,-4500,-8138588,Debit
2025-01-21,Medical Store,Health,-6659,-8145247,Debit
2024-05-15,Cafe Coffee Day,Food,-4118,-8149365,Debit
2024-08-31,Flipkart Order,Shopping,-1944,-8151309,Debit
2025-05-10,Movie Tickets,Entertainment,-7327,-8158636,Debit
2025-03-16,Movie Tickets,Entertainment,-4169,-8162805,Debit
2025-01-09,Internet Recharge,Utilities,-6561,-8169366,Debit
2024-04-19,Cash Deposit,Cash,-8164,-8177530,Debit
2024-08-19,Medical Store,Health,-5164,-8182694,Debit
2024-03-11,FD Interest,Savings Interest,20235,-8162459,Credit
2024-09-14,Train Ticket,Transport,-158,-8162617,Debit
2024-02-15,Cafe Coffee Day,Food,-1620,-8164237,Debit
2024-01-23,Interest Credit,Savings Interest,29903,-8134334,Credit
2024-04-25,Petrol,Transport,-6691,-8141025,Debit
2024-03-06,Myntra Shopping,Shopping,-1330,-8142355,Debit
2024-06-21,Restaurant Bill,Food,-3093,-8145448,Debit
2025-02-16,Salary Credit,Income,15035,-8130413,Credit
2024-09-28,Swiggy,Food,-9354,-8139767,Debit
2024-11-15,Bonus,Income,14153,-8125614,Credit
2025-03-04,Train Ticket,Transport,-8823,-8134437,Debit
2024-03-02,Received from Rahul,Transfer,-7806,-8142243,Debit
2024-10-06,Refund,Income,9698,-8132545,Credit
2025-03-12,Internet Recharge,Utilities,-8113,-8140658,Debit
2024-05-12,Interest Credit,Savings Interest,11045,-8129613,Credit
2024-11-12,Petrol,Transport,-7313,-8136926,Debit
2024-09-01,FD Interest,Savings Interest,1500,-8135426,Credit
2025-01-14,YouTube Premium,Entertainment,-1119,-8136545,Debit
2024-09-19,Internet Recharge,Utilities,-2351,-8138896,Debit
2025-01-25,Zomato Order,Food,-121,-8139017,Debit
2024-02-28,YouTube Premium,Entertainment,-9341,-8148358,Debit
2024-04-20,Cafe Coffee Day,Food,-870,-8149228,Debit
2025-01-11,Internet Recharge,Utilities,-6597,-8155825,Debit
2024-09-06,Amazon Purchase,Shopping,-8496,-8164321,Debit
2025-01-25,ATM Withdrawal,Cash,-3683,-8168004,Debit
2024-11-19,Electricity Bill,Utilities,-7408,-8175412,Debit
2025-04-20,Flipkart Order,Shopping,-7133,-8182545,Debit
2025-03-05,YouTube Premium,Entertainment,-2558,-8185103,Debit
2024-01-29,Freelance Payment,Income,22987,-8162116,Credit
2025-02-20,Medical Store,Health,-6297,-8168413,Debit
2024-02-28,Doctor Visit,Health,-4132,-8172545,Debit
2024-01-06,Medical Store,Health,-5189,-8177734,Debit
2025-03-28,Myntra Shopping,Shopping,-654,-8178388,Debit
2024-01-30,Train Ticket,Transport,-9439,-8187827,Debit
2024-12-10,Petrol,Transport,-2015,-8189842,Debit
2025-02-20,Medical Store,Health,-2604,-8192446,Debit
2024-04-29,Spotify,Entertainment,-766,-8193212,Debit
2024-10-22,Medical Store,Health,-3177,-8196389,Debit
2024-04-03,Freelance Payment,Income,21694,-8174695,Credit
2025-04-28,Bonus,Income,10877,-8163818,Credit
2025-01-20,Bank Transfer,Transfer,-3100,-8166918,Debit
2025-01-12,Salary Credit,Income,3306,-8163612,Credit
2024-11-15,Refund,Income,837,-8162775,Credit
2024-02-12,Interest Credit,Savings Interest,1225,-8161550,Credit
2024-10-13,Cafe Coffee Day,Food,-4960,-8166510,Debit
2024-05-19,Medical Store,Health,-6988,-8173498,Debit
2024-11-25,Spotify,Entertainment,-693,-8174191,Debit
2025-03-18,Flipkart Order,Shopping,-2989,-8177180,Debit
2024-02-10,Uber Ride,Transport,-4442,-8181622,Debit
2024-03-21,FD Interest,Savings Interest,595,-8181027,Credit
2025-05-09,FD Interest,Savings Interest,20487,-8160540,Credit
2025-02-14,Spotify,Entertainment,-5221,-8165761,Debit
2024-06-06,Bank Transfer,Transfer,-213,-8165974,Debit
2024-07-24,Doctor Visit,Health,-4990,-8170964,Debit
2024-11-28,Restaurant Bill,Food,-4518,-8175482,Debit
2025-01-12,Swiggy,Food,-8535,-8184017,Debit
2024-05-31,Cash Deposit,Cash,-3345,-8187362,Debit
2025-04-22,Freelance Payment,Income,27215,-8160147,Credit
2024-06-10,Spotify,Entertainment,-7815,-8167962,Debit
2024-06-21,Water Bill,Utilities,-1867,-8169829,Debit
2024-12-20,Internet Recharge,Utilities,-7634,-8177463,Debit
2024-11-22,Received from Rahul,Transfer,-9904,-8187367,Debit
2024-09-13,Freelance Payment,Income,26619,-8160748,Credit
2024-07-21,Spotify,Entertainment,-6377,-8167125,Debit
2024-04-17,Doctor Visit,Health,-6056,-8173181,Debit
2024-12-14,Internet Recharge,Utilities,-2611,-8175792,Debit
2024-07-10,Interest Credit,Savings Interest,15131,-8160661,Credit
2024-09-24,Petrol,Transport,-4137,-8164798,Debit
2025-02-23,Interest Credit,Savings Interest,22775,-8142023,Credit
2024-06-10,Uber Ride,Transport,-8386,-8150409,Debit
2024-12-18,Myntra Shopping,Shopping,-8308,-8158717,Debit
2024-01-19,Zomato Order,Food,-6277,-8164994,Debit
2024-02-20,Internet Recharge,Utilities,-2427,-8167421,Debit
2024-12-24,Uber Ride,Transport,-6151,-8173572,Debit
2025-05-07,Electricity Bill,Utilities,-5871,-8179443,Debit
2024-06-28,Freelance Payment,Income,27031,-8152412,Credit
2024-02-23,ATM Withdrawal,Cash,-7423,-8159835,Debit
2024-04-19,Interest Credit,Savings Interest,4889,-8154946,Credit
2025-04-14,Bank Transfer,Transfer,-1537,-8156483,Debit
2024-08-18,FD Interest,Savings Interest,10938,-8145545,Credit
2025-01-22,Internet Recharge,Utilities,-3717,-8149262,Debit
2024-07-12,Refund,Income,667,-8148595,Credit
2025-02-14,Refund,Income,3146,-8145449,Credit
2025-05-10,Cash Deposit,Cash,-9885,-8155334,Debit
2025-04-10,Electronics,Shopping,-9863,-8165197,Debit
2025-02-15,Interest Credit,Savings Interest,5503,-8159694,Credit
2025-01-20,ATM Withdrawal,Cash,-1544,-8161238,Debit
2024-07-31,Freelance Payment,Income,21413,-8139825,Credit
2024-04-24,YouTube Premium,Entertainment,-7761,-8147586,Debit
2025-04-23,Cash Deposit,Cash,-931,-8148517,Debit
2024-10-28,Bonus,Income,4271,-8144246,Credit
2024-02-07,Salary Credit,Income,14926,-8129320,Credit
2024-01-22,Cash Deposit,Cash,-5241,-8134561,Debit
2024-03-30,UPI to Friend,Transfer,-1123,-8135684,Debit
2024-05-06,Uber Ride,Transport,-7372,-8143056,Debit
2024-11-02,FD Interest,Savings Interest,1544,-8141512,Credit
2024-08-26,Water Bill,Utilities,-7887,-8149399,Debit
2024-10-11,Received from Rahul,Transfer,-3988,-8153387,Debit
2025-04-02,FD Interest,Savings Interest,26046,-8127341,Credit
2025-02-02,Electricity Bill,Utilities,-4998,-8132339,Debit
2024-10-03,Uber Ride,Transport,-9793,-8142132,Debit
2024-02-28,Freelance Payment,Income,670,-8141462,Credit
2025-05-14,Cash Deposit,Cash,-7020,-8148482,Debit
2025-01-14,Medical Store,Health,-2818,-8151300,Debit
2024-04-01,Water Bill,Utilities,-1241,-8152541,Debit
2024-12-04,Petrol,Transport,-325,-8152866,Debit
2024-05-13,Restaurant Bill,Food,-844,-8153710,Debit
2024-05-22,Internet Recharge,Utilities,-8216,-8161926,Debit
2024-11-11,Interest Credit,Savings Interest,5017,-8156909,Credit
2024-02-23,Interest Credit,Savings Interest,26684,-8130225,Credit
2024-01-30,Internet Recharge,Utilities,-1261,-8131486,Debit
2024-12-31,Myntra Shopping,Shopping,-6644,-8138130,Debit
2025-05-11,ATM Withdrawal,Cash,-8117,-8146247,Debit
2025-02-07,Medical Store,Health,-7589,-8153836,Debit
2024-02-09,UPI to Friend,Transfer,-7550,-8161386,Debit
2024-09-20,Medical Store,Health,-1441,-8162827,Debit
2024-06-02,Medical Store,Health,-6155,-8168982,Debit
2024-09-27,Bonus,Income,1471,-8167511,Credit
2024-04-29,YouTube Premium,Entertainment,-3654,-8171165,Debit
2024-01-04,Flipkart Order,Shopping,-3144,-8174309,Debit
2024-10-25,Salary Credit,Income,11061,-8163248,Credit
2024-11-24,Bonus,Income,25701,-8137547,Credit
2024-01-10,Doctor Visit,Health,-8498,-8146045,Debit
2024-06-19,YouTube Premium,Entertainment,-302,-8146347,Debit
2024-06-27,Uber Ride,Transport,-3955,-8150302,Debit
2025-05-07,Freelance Payment,Income,4827,-8145475,Credit
2025-04-01,Interest Credit,Savings Interest,7613,-8137862,Credit
2024-10-18,YouTube Premium,Entertainment,-5860,-8143722,Debit
2024-07-05,ATM Withdrawal,Cash,-6813,-8150535,Debit
2024-09-17,Bonus,Income,21132,-8129403,Credit
2025-03-01,Myntra Shopping,Shopping,-1728,-8131131,Debit
2024-10-16,Interest Credit,Savings Interest,17748,-8113383,Credit
2024-01-13,Flipkart Order,Shopping,-6325,-8119708,Debit
2024-05-06,Electronics,Shopping,-8195,-8127903,Debit
2025-01-17,Cash Deposit,Cash,-9593,-8137496,Debit
2024-12-06,UPI to Friend,Transfer,-9634,-8147130,Debit
2024-06-15,Spotify,Entertainment,-706,-8147836,Debit
2024-04-11,Restaurant Bill,Food,-9486,-8157322,Debit
2024-01-21,Received from Rahul,Transfer,-1231,-8158553,Debit
2024-06-16,Spotify,Entertainment,-3476,-8162029,Debit
2024-07-16,Flipkart Order,Shopping,-4173,-8166202,Debit
2024-06-27,Flipkart Order,Shopping,-9739,-8175941,Debit
2025-01-15,Salary Credit,Income,20999,-8154942,Credit
2024-07-09,Salary Credit,Income,17806,-8137136,Credit
2024-07-02,Spotify,Entertainment,-9727,-8146863,Debit
2024-05-28,Interest Credit,Savings Interest,13244,-8133619,Credit
2025-03-30,Bonus,Income,27213,-8106406,Credit
2024-03-01,Uber Ride,Transport,-1113,-8107519,Debit
2025-01-15,Restaurant Bill,Food,-8444,-8115963,Debit
2024-06-20,Train Ticket,Transport,-3153,-8119116,Debit
2025-01-30,YouTube Premium,Entertainment,-9318,-8128434,Debit
2025-04-11,Restaurant Bill,Food,-1096,-8129530,Debit
2024-04-06,Movie Tickets,Entertainment,-8799,-8138329,Debit
2025-03-04,Freelance Payment,Income,19926,-8118403,Credit
2024-04-02,Petrol,Transport,-3252,-8121655,Debit
2025-05-03,Movie Tickets,Entertainment,-7369,-8129024,Debit
2024-05-04,Electricity Bill,Utilities,-9123,-8138147,Debit
2024-05-09,ATM Withdrawal,Cash,-1139,-8139286,Debit
2025-03-01,Spotify,Entertainment,-885,-8140171,Debit
2025-03-17,Internet Recharge,Utilities,-978,-8141149,Debit
2024-01-22,Cash Deposit,Cash,-2025,-8143174,Debit
2024-09-15,Internet Recharge,Utilities,-1570,-8144744,Debit
2024-08-22,UPI to Friend,Transfer,-1852,-8146596,Debit
2024-05-26,FD Interest,Savings Interest,24678,-8121918,Credit
2024-10-17,Swiggy,Food,-8392,-8130310,Debit
2024-05-17,Petrol,Transport,-4610,-8134920,Debit
2025-03-10,Interest Credit,Savings Interest,5756,-8129164,Credit
2024-01-14,Cash Deposit,Cash,-3104,-8132268,Debit
2024-03-19,FD Interest,Savings Interest,19009,-8113259,Credit
2024-03-28,Medical Store,Health,-7888,-8121147,Debit
2025-03-14,Doctor Visit,Health,-5450,-8126597,Debit
2024-12-31,FD Interest,Savings Interest,13871,-8112726,Credit
2024-06-28,Restaurant Bill,Food,-9369,-8122095,Debit
2024-08-27,Medical Store,Health,-3732,-8125827,Debit
2024-11-06,Myntra Shopping,Shopping,-9680,-8135507,Debit
2024-03-01,Interest Credit,Savings Interest,29649,-8105858,Credit
2025-02-12,Zomato Order,Food,-6028,-8111886,Debit
2024-12-03,Refund,Income,10204,-8101682,Credit
2024-05-06,Zomato Order,Food,-7223,-8108905,Debit
2024-09-13,Zomato Order,Food,-6442,-8115347,Debit
2025-02-23,ATM Withdrawal,Cash,-6318,-8121665,Debit
2024-02-14,Bank Transfer,Transfer,-5351,-8127016,Debit
2025-03-15,Water Bill,Utilities,-9698,-8136714,Debit
2024-06-25,YouTube Premium,Entertainment,-5831,-8142545,Debit
2025-02-02,Doctor Visit,Health,-4960,-8147505,Debit
2024-04-03,Medical Store,Health,-5149,-8152654,Debit
2024-05-08,Doctor Visit,Health,-1918,-8154572,Debit
2024-09-08,Train Ticket,Transport,-6637,-8161209,Debit
2024-11-08,Received from Rahul,Transfer,-2562,-8163771,Debit
2024-01-26,YouTube Premium,Entertainment,-2291,-8166062,Debit
2024-03-27,Amazon Purchase,Shopping,-2302,-8168364,Debit
2025-01-27,Refund,Income,25900,-8142464,Credit
2024-02-01,Medical Store,Health,-6294,-8148758,Debit
2024-02-12,Medical Store,Health,-4716,-8153474,Debit
2025-04-17,Cash Deposit,Cash,-810,-8154284,Debit
2024-04-30,Interest Credit,Savings Interest,24223,-8130061,Credit
2024-03-08,UPI to Friend,Transfer,-4034,-8134095,Debit
2024-01-20,FD Interest,Savings Interest,29442,-8104653,Credit
2024-07-24,Water Bill,Utilities,-900,-8105553,Debit
2024-11-17,Bank Transfer,Transfer,-7933,-8113486,Debit
2024-06-26,Doctor Visit,Health,-9802,-8123288,Debit
2024-06-08,Doctor Visit,Health,-774,-8124062,Debit
2024-07-02,Water Bill,Utilities,-6612,-8130674,Debit
2025-04-30,Medical Store,Health,-985,-8131659,Debit
2024-07-16,Refund,Income,15308,-8116351,Credit
2024-06-02,Cash Deposit,Cash,-7679,-8124030,Debit
2024-09-19,Refund,Income,10072,-8113958,Credit
2024-11-09,Petrol,Transport,-6343,-8120301,Debit
2024-05-27,FD Interest,Savings Interest,4127,-8116174,Credit
2024-04-18,Bonus,Income,2666,-8113508,Credit
2024-01-13,Medical Store,Health,-4382,-8117890,Debit
2024-10-25,ATM Withdrawal,Cash,-1674,-8119564,Debit
2024-10-21,Restaurant Bill,Food,-4045,-8123609,Debit
2025-04-25,Medical Store,Health,-4934,-8128543,Debit
2024-04-16,Doctor Visit,Health,-8547,-8137090,Debit
2025-02-24,Train Ticket,Transport,-8676,-8145766,Debit
2025-01-15,Interest Credit,Savings Interest,29869,-8115897,Credit
2025-01-04,Bonus,Income,4967,-8110930,Credit
2024-05-27,Restaurant Bill,Food,-6938,-8117868,Debit
2024-05-26,Electricity Bill,Utilities,-7864,-8125732,Debit
2024-02-02,Swiggy,Food,-6881,-8132613,Debit
2025-03-05,Spotify,Entertainment,-9481,-8142094,Debit
2024-02-29,Movie Tickets,Entertainment,-9109,-8151203,Debit
2024-07-07,Interest Credit,Savings Interest,15186,-8136017,Credit
2024-07-28,Train Ticket,Transport,-7666,-8143683,Debit
2024-08-18,Swiggy,Food,-1686,-8145369,Debit
2024-03-05,ATM Withdrawal,Cash,-2344,-8147713,Debit
2024-09-22,FD Interest,Savings Interest,12165,-8135548,Credit
2024-08-30,ATM Withdrawal,Cash,-2424,-8137972,Debit
2025-05-11,Petrol,Transport,-8529,-8146501,Debit
2024-10-27,Medical Store,Health,-6700,-8153201,Debit
2025-03-26,ATM Withdrawal,Cash,-8598,-8161799,Debit
2025-02-23,Received from Rahul,Transfer,-2377,-8164176,Debit
2024-06-14,Amazon Purchase,Shopping,-8451,-8172627,Debit
2025-03-27,Internet Recharge,Utilities,-1842,-8174469,Debit
2025-02-09,Internet Recharge,Utilities,-138,-8174607,Debit
2024-09-28,Cash Deposit,Cash,-2257,-8176864,Debit
2024-05-20,Bank Transfer,Transfer,-4038,-8180902,Debit
2024-01-12,Bank Transfer,Transfer,-9118,-8190020,Debit
2024-08-20,Petrol,Transport,-8331,-8198351,Debit
2024-07-28,Received from Rahul,Transfer,-3227,-8201578,Debit
2025-04-11,Train Ticket,Transport,-539,-8202117,Debit
2024-02-27,YouTube Premium,Entertainment,-2802,-8204919,Debit
2024-01-25,Movie Tickets,Entertainment,-9104,-8214023,Debit
2024-03-02,Spotify,Entertainment,-8756,-8222779,Debit
2024-10-15,Zomato Order,Food,-5877,-8228656,Debit
2024-03-23,Uber Ride,Transport,-9821,-8238477,Debit
2025-01-24,Bank Transfer,Transfer,-9142,-8247619,Debit
2024-12-09,Received from Rahul,Transfer,-6575,-8254194,Debit
2025-03-25,Restaurant Bill,Food,-5831,-8260025,Debit
2024-06-15,Water Bill,Utilities,-9451,-8269476,Debit
2025-04-01,FD Interest,Savings Interest,20794,-8248682,Credit
2025-02-10,Cash Deposit,Cash,-9247,-8257929,Debit
2025-04-28,Cash Deposit,Cash,-5995,-8263924,Debit
2024-03-03,Internet Recharge,Utilities,-788,-8264712,Debit
2024-09-24,Amazon Purchase,Shopping,-3399,-8268111,Debit
2024-11-29,Flipkart Order,Shopping,-742,-8268853,Debit
2024-04-27,Bonus,Income,7340,-8261513,Credit
2025-02-22,UPI to Friend,Transfer,-2969,-8264482,Debit
2024-12-01,Doctor Visit,Health,-7088,-8271570,Debit
2024-05-20,Cafe Coffee Day,Food,-4404,-8275974,Debit
2024-05-08,UPI to Friend,Transfer,-1565,-8277539,Debit
2025-04-16,Electronics,Shopping,-1147,-8278686,Debit
2024-02-06,Medical Store,Health,-2787,-8281473,Debit
2024-09-28,Received from Rahul,Transfer,-1151,-8282624,Debit
2025-04-09,Bonus,Income,9881,-8272743,Credit
2025-03-27,Restaurant Bill,Food,-7846,-8280589,Debit
2024-01-28,Bank Transfer,Transfer,-7931,-8288520,Debit
2025-01-05,Movie Tickets,Entertainment,-9432,-8297952,Debit
2025-01-11,Petrol,Transport,-3548,-8301500,Debit
2025-03-18,Electricity Bill,Utilities,-5943,-8307443,Debit
2024-11-19,Salary Credit,Income,27202,-8280241,Credit
2024-05-20,Interest Credit,Savings Interest,22151,-8258090,Credit
2025-01-01,Uber Ride,Transport,-8203,-8266293,Debit
2025-02-08,UPI to Friend,Transfer,-3925,-8270218,Debit
2024-07-28,FD Interest,Savings Interest,18676,-8251542,Credit
2024-07-02,Bonus,Income,28541,-8223001,Credit
2024-01-08,ATM Withdrawal,Cash,-374,-8223375,Debit
2024-12-04,FD Interest,Savings Interest,25972,-8197403,Credit
2024-05-12,Uber Ride,Transport,-7543,-8204946,Debit
2024-04-05,Bank Transfer,Transfer,-9288,-8214234,Debit
2025-03-13,Bank Transfer,Transfer,-2176,-8216410,Debit
2024-11-11,Doctor Visit,Health,-7660,-8224070,Debit
2024-01-31,Medical Store,Health,-8741,-8232811,Debit
2025-01-04,UPI to Friend,Transfer,-1160,-8233971,Debit
2025-03-13,Uber Ride,Transport,-8716,-8242687,Debit
2025-02-21,ATM Withdrawal,Cash,-6422,-8249109,Debit
2024-10-16,Train Ticket,Transport,-3874,-8252983,Debit
2024-02-14,Refund,Income,23898,-8229085,Credit
2025-03-17,FD Interest,Savings Interest,4187,-8224898,Credit
2024-10-18,ATM Withdrawal,Cash,-3405,-8228303,Debit
2024-02-15,ATM Withdrawal,Cash,-7611,-8235914,Debit
2024-02-14,Freelance Payment,Income,18563,-8217351,Credit
2024-02-05,YouTube Premium,Entertainment,-6886,-8224237,Debit
2024-07-27,Water Bill,Utilities,-8678,-8232915,Debit
2025-04-02,Bonus,Income,5266,-8227649,Credit
2024-06-24,Cash Deposit,Cash,-9840,-8237489,Debit
2025-01-14,Petrol,Transport,-6381,-8243870,Debit
2025-02-22,Interest Credit,Savings Interest,29858,-8214012,Credit
2025-04-16,Flipkart Order,Shopping,-1488,-8215500,Debit
2024-10-13,Electricity Bill,Utilities,-8042,-8223542,Debit
2024-04-18,Salary Credit,Income,1812,-8221730,Credit
2025-04-29,Electricity Bill,Utilities,-6741,-8228471,Debit
2024-04-24,FD Interest,Savings Interest,4891,-8223580,Credit
2024-11-13,Medical Store,Health,-9390,-8232970,Debit
2025-02-11,Salary Credit,Income,8481,-8224489,Credit
2024-02-06,Medical Store,Health,-226,-8224715,Debit
2024-08-20,Interest Credit,Savings Interest,1553,-8223162,Credit
2025-04-13,Received from Rahul,Transfer,-8129,-8231291,Debit
2025-05-14,Amazon Purchase,Shopping,-3082,-8234373,Debit
2025-03-06,Received from Rahul,Transfer,-1540,-8235913,Debit
2024-11-18,Interest Credit,Savings Interest,15993,-8219920,Credit
2024-05-01,Water Bill,Utilities,-8350,-8228270,Debit
2024-06-10,Doctor Visit,Health,-7420,-8235690,Debit
2025-04-08,ATM Withdrawal,Cash,-4456,-8240146,Debit
2024-06-07,UPI to Friend,Transfer,-3385,-8243531,Debit
2024-02-19,Medical Store,Health,-5595,-8249126,Debit
2024-09-14,Flipkart Order,Shopping,-2602,-8251728,Debit
2024-05-08,Electricity Bill,Utilities,-7392,-8259120,Debit
2024-06-21,Doctor Visit,Health,-798,-8259918,Debit
2024-03-31,Electricity Bill,Utilities,-1005,-8260923,Debit
2024-04-16,Amazon Purchase,Shopping,-9416,-8270339,Debit
2024-07-26,Petrol,Transport,-4928,-8275267,Debit
2024-09-21,Flipkart Order,Shopping,-6594,-8281861,Debit
2024-07-25,Cash Deposit,Cash,-8357,-8290218,Debit
2024-03-14,Movie Tickets,Entertainment,-3680,-8293898,Debit
2024-09-13,Swiggy,Food,-2529,-8296427,Debit
2024-11-05,Flipkart Order,Shopping,-6807,-8303234,Debit
2024-08-06,Bank Transfer,Transfer,-3866,-8307100,Debit
2024-10-11,Cash Deposit,Cash,-6944,-8314044,Debit
2025-04-15,Electronics,Shopping,-8474,-8322518,Debit
2024-05-26,Bank Transfer,Transfer,-6175,-8328693,Debit
2024-08-30,Internet Recharge,Utilities,-650,-8329343,Debit
2024-08-02,Cafe Coffee Day,Food,-7680,-8337023,Debit
2024-11-19,Cafe Coffee Day,Food,-6317,-8343340,Debit
2024-03-16,ATM Withdrawal,Cash,-6889,-8350229,Debit
2024-02-25,Myntra Shopping,Shopping,-8311,-8358540,Debit
2024-10-29,Movie Tickets,Entertainment,-7191,-8365731,Debit
2025-03-20,Refund,Income,24199,-8341532,Credit
2024-08-24,Uber Ride,Transport,-320,-8341852,Debit
2024-03-27,Water Bill,Utilities,-825,-8342677,Debit
2025-04-27,Medical Store,Health,-775,-8343452,Debit
2024-06-07,Water Bill,Utilities,-7644,-8351096,Debit
2025-04-02,Restaurant Bill,Food,-6038,-8357134,Debit
2025-04-14,Water Bill,Utilities,-3422,-8360556,Debit
2024-12-07,Doctor Visit,Health,-4775,-8365331,Debit
2024-12-05,ATM Withdrawal,Cash,-464,-8365795,Debit
2024-12-30,Cafe Coffee Day,Food,-9194,-8374989,Debit
2024-02-07,Interest Credit,Savings Interest,5832,-8369157,Credit
2024-07-16,YouTube Premium,Entertainment,-3334,-8372491,Debit
2024-05-28,Medical Store,Health,-1838,-8374329,Debit
2025-01-06,Bank Transfer,Transfer,-1236,-8375565,Debit
2025-02-25,Amazon Purchase,Shopping,-7251,-8382816,Debit
2025-02-22,Internet Recharge,Utilities,-9397,-8392213,Debit
2024-01-28,Petrol,Transport,-8862,-8401075,Debit
2024-02-18,Refund,Income,17199,-8383876,Credit
2024-01-17,Zomato Order,Food,-6183,-8390059,Debit
2024-03-19,Salary Credit,Income,16558,-8373501,Credit
2024-01-04,Doctor Visit,Health,-7648,-8381149,Debit
2024-01-28,Interest Credit,Savings Interest,8868,-8372281,Credit
2024-01-14,Movie Tickets,Entertainment,-2689,-8374970,Debit
2025-03-05,UPI to Friend,Transfer,-8442,-8383412,Debit
2024-09-23,YouTube Premium,Entertainment,-9190,-8392602,Debit
2025-01-18,FD Interest,Savings Interest,1955,-8390647,Credit
2024-03-14,Amazon Purchase,Shopping,-848,-8391495,Debit
2024-01-23,Salary Credit,Income,2061,-8389434,Credit
2024-03-08,Received from Rahul,Transfer,-6189,-8395623,Debit
2024-08-02,Flipkart Order,Shopping,-7045,-8402668,Debit
2025-03-05,Petrol,Transport,-2423,-8405091,Debit
2025-05-15,Doctor Visit,Health,-1616,-8406707,Debit
2025-05-02,Electricity Bill,Utilities,-3332,-8410039,Debit
2024-07-28,Bonus,Income,24164,-8385875,Credit
2024-04-20,Zomato Order,Food,-193,-8386068,Debit
2024-08-12,FD Interest,Savings Interest,19777,-8366291,Credit
2024-11-15,Refund,Income,27251,-8339040,Credit
2025-03-02,Interest Credit,Savings Interest,8169,-8330871,Credit
2024-10-04,Movie Tickets,Entertainment,-5798,-8336669,Debit
2024-10-24,Zomato Order,Food,-5814,-8342483,Debit
2025-03-31,Doctor Visit,Health,-3055,-8345538,Debit
2024-01-10,Internet Recharge,Utilities,-6831,-8352369,Debit
2024-05-13,YouTube Premium,Entertainment,-9795,-8362164,Debit
2024-08-31,Train Ticket,Transport,-3996,-8366160,Debit
2025-04-13,Zomato Order,Food,-6526,-8372686,Debit
2025-04-16,Petrol,Transport,-681,-8373367,Debit
2025-03-25,Water Bill,Utilities,-9360,-8382727,Debit
2024-10-10,Salary Credit,Income,22096,-8360631,Credit
2024-04-02,ATM Withdrawal,Cash,-1871,-8362502,Debit
2024-05-08,Zomato Order,Food,-4109,-8366611,Debit
2024-06-15,Interest Credit,Savings Interest,11549,-8355062,Credit
2025-03-04,FD Interest,Savings Interest,21812,-8333250,Credit
2024-02-27,Bank Transfer,Transfer,-5939,-8339189,Debit
2024-06-10,ATM Withdrawal,Cash,-9181,-8348370,Debit
2024-10-06,Cash Deposit,Cash,-193,-8348563,Debit
2024-08-12,UPI to Friend,Transfer,-7664,-8356227,Debit
2024-06-18,Flipkart Order,Shopping,-7602,-8363829,Debit
2024-11-29,Bank Transfer,Transfer,-1398,-8365227,Debit
2024-10-08,Spotify,Entertainment,-8379,-8373606,Debit
2024-09-22,Refund,Income,20222,-8353384,Credit
2024-04-13,ATM Withdrawal,Cash,-4449,-8357833,Debit
2024-02-27,UPI to Friend,Transfer,-4338,-8362171,Debit
2025-01-05,Refund,Income,14219,-8347952,Credit
2024-09-02,FD Interest,Savings Interest,19457,-8328495,Credit
2024-07-23,Swiggy,Food,-4727,-8333222,Debit
2024-10-17,Refund,Income,1954,-8331268,Credit
2024-07-08,Train Ticket,Transport,-8809,-8340077,Debit
2024-05-16,Myntra Shopping,Shopping,-9356,-8349433,Debit
2024-03-13,Freelance Payment,Income,15047,-8334386,Credit
2024-01-12,YouTube Premium,Entertainment,-4798,-8339184,Debit
2025-04-10,ATM Withdrawal,Cash,-125,-8339309,Debit
2024-04-13,Amazon Purchase,Shopping,-5006,-8344315,Debit
2024-02-01,Zomato Order,Food,-1560,-8345875,Debit
2025-05-13,Bank Transfer,Transfer,-9994,-8355869,Debit
2024-07-17,Petrol,Transport,-776,-8356645,Debit
2024-07-19,Flipkart Order,Shopping,-7609,-8364254,Debit
2024-09-18,Salary Credit,Income,13585,-8350669,Credit
2024-10-07,Myntra Shopping,Shopping,-1922,-8352591,Debit
2025-03-21,Freelance Payment,Income,5536,-8347055,Credit
2024-11-05,Uber Ride,Transport,-9806,-8356861,Debit
2024-08-09,Restaurant Bill,Food,-8980,-8365841,Debit
2025-02-10,Electronics,Shopping,-7244,-8373085,Debit
2024-05-22,Received from Rahul,Transfer,-5516,-8378601,Debit
2024-05-03,Petrol,Transport,-6169,-8384770,Debit
2024-03-16,Uber Ride,Transport,-434,-8385204,Debit
2025-05-11,Amazon Purchase,Shopping,-5392,-8390596,Debit
2024-09-07,Interest Credit,Savings Interest,12026,-8378570,Credit
2024-02-09,Freelance Payment,Income,27072,-8351498,Credit
2024-08-20,Spotify,Entertainment,-7925,-8359423,Debit
2024-11-28,Water Bill,Utilities,-9673,-8369096,Debit
2024-08-04,YouTube Premium,Entertainment,-1267,-8370363,Debit
2024-02-07,Interest Credit,Savings Interest,14398,-8355965,Credit
2024-08-21,Cafe Coffee Day,Food,-904,-8356869,Debit
2024-01-14,Flipkart Order,Shopping,-9991,-8366860,Debit
2024-11-12,Myntra Shopping,Shopping,-9747,-8376607,Debit
2025-05-01,Bank Transfer,Transfer,-6878,-8383485,Debit
2024-03-16,Movie Tickets,Entertainment,-5586,-8389071,Debit
2025-04-18,Cash Deposit,Cash,-3758,-8392829,Debit
2024-12-19,Bonus,Income,23519,-8369310,Credit
2025-01-18,Cash Deposit,Cash,-3558,-8372868,Debit
2024-01-27,Bank Transfer,Transfer,-8407,-8381275,Debit
2025-02-12,UPI to Friend,Transfer,-6098,-8387373,Debit
2024-07-27,Internet Recharge,Utilities,-8348,-8395721,Debit
2024-01-12,Amazon Purchase,Shopping,-2287,-8398008,Debit
2024-01-31,Cafe Coffee Day,Food,-3653,-8401661,Debit
2024-04-27,Interest Credit,Savings Interest,1879,-8399782,Credit
2025-02-26,ATM Withdrawal,Cash,-947,-8400729,Debit
2024-08-01,UPI to Friend,Transfer,-2218,-8402947,Debit
2024-03-26,Myntra Shopping,Shopping,-676,-8403623,Debit
2024-10-12,Amazon Purchase,Shopping,-5901,-8409524,Debit
2025-04-22,Internet Recharge,Utilities,-9354,-8418878,Debit
2024-12-22,FD Interest,Savings Interest,689,-8418189,Credit
2024-03-21,Cash Deposit,Cash,-2247,-8420436,Debit
2025-04-16,Doctor Visit,Health,-3135,-8423571,Debit
2025-03-15,Refund,Income,16879,-8406692,Credit
2025-01-30,Cafe Coffee Day,Food,-1783,-8408475,Debit
2025-01-01,Doctor Visit,Health,-7984,-8416459,Debit
2025-03-04,Uber Ride,Transport,-5119,-8421578,Debit
2024-12-19,Medical Store,Health,-7603,-8429181,Debit
2024-01-26,Salary Credit,Income,1790,-8427391,Credit
2025-01-01,UPI to Friend,Transfer,-6235,-8433626,Debit
2024-11-22,Uber Ride,Transport,-9885,-8443511,Debit
2024-12-09,Train Ticket,Transport,-3401,-8446912,Debit
2024-02-22,Received from Rahul,Transfer,-2978,-8449890,Debit
2025-01-22,Interest Credit,Savings Interest,790,-8449100,Credit
2024-03-20,Petrol,Transport,-6257,-8455357,Debit
2024-01-10,Doctor Visit,Health,-3944,-8459301,Debit
2025-02-16,Doctor Visit,Health,-6484,-8465785,Debit
2024-02-28,Doctor Visit,Health,-7438,-8473223,Debit
2024-03-11,Salary Credit,Income,20550,-8452673,Credit
2024-02-29,Electronics,Shopping,-6416,-8459089,Debit
2024-12-25,Medical Store,Health,-2065,-8461154,Debit
2024-01-22,Amazon Purchase,Shopping,-2152,-8463306,Debit
2025-03-28,Salary Credit,Income,18506,-8444800,Credit
2024-01-23,Uber Ride,Transport,-1151,-8445951,Debit
2025-01-07,Bonus,Income,12089,-8433862,Credit
2025-04-04,Movie Tickets,Entertainment,-2169,-8436031,Debit
2024-01-22,Salary Credit,Income,12954,-8423077,Credit
2025-05-03,Electricity Bill,Utilities,-4554,-8427631,Debit
2025-03-31,Zomato Order,Food,-3595,-8431226,Debit
2024-10-19,Doctor Visit,Health,-1175,-8432401,Debit
2024-05-09,Received from Rahul,Transfer,-4275,-8436676,Debit
2024-12-04,Flipkart Order,Shopping,-5987,-8442663,Debit
2024-08-12,Salary Credit,Income,15186,-8427477,Credit
2025-05-07,Refund,Income,13137,-8414340,Credit
2024-11-16,Interest Credit,Savings Interest,25814,-8388526,Credit
2024-10-29,Movie Tickets,Entertainment,-2980,-8391506,Debit
2024-01-05,Bank Transfer,Transfer,-9950,-8401456,Debit
2024-01-07,Swiggy,Food,-2500,-8403956,Debit
2024-03-29,Movie Tickets,Entertainment,-9601,-8413557,Debit
2024-05-15,Cafe Coffee Day,Food,-2996,-8416553,Debit
2024-01-14,Freelance Payment,Income,25309,-8391244,Credit
2024-01-05,Water Bill,Utilities,-6514,-8397758,Debit
2024-10-30,Water Bill,Utilities,-1719,-8399477,Debit
2024-03-07,Cash Deposit,Cash,-592,-8400069,Debit
2025-03-15,Myntra Shopping,Shopping,-9198,-8409267,Debit
2025-03-09,Electricity Bill,Utilities,-2071,-8411338,Debit
2025-01-01,Cafe Coffee Day,Food,-9676,-8421014,Debit
2024-07-02,UPI to Friend,Transfer,-9752,-8430766,Debit
2025-01-08,Train Ticket,Transport,-1698,-8432464,Debit
2025-01-06,Petrol,Transport,-2049,-8434513,Debit
2024-10-02,UPI to Friend,Transfer,-1153,-8435666,Debit
2024-01-24,Flipkart Order,Shopping,-2609,-8438275,Debit
2024-12-24,Interest Credit,Savings Interest,12055,-8426220,Credit
2024-02-26,Bank Transfer,Transfer,-9911,-8436131,Debit
2025-02-01,Movie Tickets,Entertainment,-6386,-8442517,Debit
2025-01-26,Cafe Coffee Day,Food,-2370,-8444887,Debit
2024-06-24,UPI to Friend,Transfer,-4639,-8449526,Debit
2024-04-18,Electricity Bill,Utilities,-3984,-8453510,Debit
2025-02-28,Amazon Purchase,Shopping,-4526,-8458036,Debit
2024-08-12,Bonus,Income,28979,-8429057,Credit
2024-12-14,Restaurant Bill,Food,-6589,-8435646,Debit
2024-06-13,Salary Credit,Income,16868,-8418778,Credit
2024-08-15,Flipkart Order,Shopping,-6450,-8425228,Debit
2024-12-20,Amazon Purchase,Shopping,-2708,-8427936,Debit
2024-10-08,Water Bill,Utilities,-5592,-8433528,Debit
2024-11-12,Refund,Income,28201,-8405327,Credit
2024-04-30,ATM Withdrawal,Cash,-5256,-8410583,Debit
2024-02-24,Interest Credit,Savings Interest,14108,-8396475,Credit
2024-02-01,Interest Credit,Savings Interest,17885,-8378590,Credit
2024-10-07,Uber Ride,Transport,-5968,-8384558,Debit
2024-08-20,Bonus,Income,24412,-8360146,Credit
2024-05-02,Internet Recharge,Utilities,-7745,-8367891,Debit
2024-07-14,Electricity Bill,Utilities,-9557,-8377448,Debit
2024-06-09,Internet Recharge,Utilities,-306,-8377754,Debit
2024-08-10,Water Bill,Utilities,-8916,-8386670,Debit
2024-06-11,Uber Ride,Transport,-3246,-8389916,Debit
2025-01-25,Electronics,Shopping,-3451,-8393367,Debit
2024-05-13,Medical Store,Health,-4881,-8398248,Debit
2024-09-28,Interest Credit,Savings Interest,28630,-8369618,Credit
2024-04-12,Amazon Purchase,Shopping,-8847,-8378465,Debit
2024-10-25,Amazon Purchase,Shopping,-8602,-8387067,Debit
2024-06-07,Freelance Payment,Income,17262,-8369805,Credit
2024-08-25,Swiggy,Food,-1077,-8370882,Debit
2025-01-25,Restaurant Bill,Food,-9759,-8380641,Debit
2025-05-15,Flipkart Order,Shopping,-4334,-8384975,Debit
2024-02-10,Zomato Order,Food,-8430,-8393405,Debit
2024-04-12,Cash Deposit,Cash,-155,-8393560,Debit
2024-02-20,Spotify,Entertainment,-7093,-8400653,Debit
2024-05-07,Interest Credit,Savings Interest,19527,-8381126,Credit
2024-03-26,Spotify,Entertainment,-6383,-8387509,Debit
2024-04-20,Spotify,Entertainment,-5618,-8393127,Debit
2024-06-22,Bank Transfer,Transfer,-6372,-8399499,Debit
2025-02-07,UPI to Friend,Transfer,-9634,-8409133,Debit
2025-04-21,Train Ticket,Transport,-5898,-8415031,Debit
2024-01-29,Cash Deposit,Cash,-2588,-8417619,Debit
2024-04-03,Refund,Income,24428,-8393191,Credit
2024-10-18,Uber Ride,Transport,-4439,-8397630,Debit
2025-02-16,Petrol,Transport,-4606,-8402236,Debit
2024-01-22,Refund,Income,18701,-8383535,Credit
2024-02-27,Interest Credit,Savings Interest,24661,-8358874,Credit
2024-08-06,Cafe Coffee Day,Food,-6941,-8365815,Debit
2025-02-18,Amazon Purchase,Shopping,-6964,-8372779,Debit
2025-02-23,Amazon Purchase,Shopping,-9789,-8382568,Debit
2024-02-19,Zomato Order,Food,-5529,-8388097,Debit
2024-06-02,Salary Credit,Income,10653,-8377444,Credit
2025-03-29,ATM Withdrawal,Cash,-9794,-8387238,Debit
2025-03-22,Freelance Payment,Income,10552,-8376686,Credit
2024-07-15,Medical Store,Health,-6702,-8383388,Debit
2024-04-08,Refund,Income,22454,-8360934,Credit
2024-09-13,ATM Withdrawal,Cash,-4447,-8365381,Debit
2024-02-26,Interest Credit,Savings Interest,27829,-8337552,Credit
2024-07-19,Myntra Shopping,Shopping,-5217,-8342769,Debit
2024-04-09,ATM Withdrawal,Cash,-5934,-8348703,Debit
2024-03-31,Doctor Visit,Health,-2106,-8350809,Debit
2024-12-08,Interest Credit,Savings Interest,19758,-8331051,Credit
2024-08-18,Petrol,Transport,-5423,-8336474,Debit
2024-09-03,Electronics,Shopping,-8576,-8345050,Debit
2024-11-21,Internet Recharge,Utilities,-4093,-8349143,Debit
2024-02-03,ATM Withdrawal,Cash,-4742,-8353885,Debit
2024-09-08,Electronics,Shopping,-1676,-8355561,Debit
2024-05-19,Swiggy,Food,-3612,-8359173,Debit
2024-05-19,Water Bill,Utilities,-8216,-8367389,Debit
2025-01-04,Interest Credit,Savings Interest,17580,-8349809,Credit
2024-04-20,Movie Tickets,Entertainment,-6478,-8356287,Debit
2025-03-04,Bank Transfer,Transfer,-2776,-8359063,Debit
2024-12-03,Medical Store,Health,-4324,-8363387,Debit
2025-01-24,Spotify,Entertainment,-5644,-8369031,Debit
2024-06-04,Medical Store,Health,-8655,-8377686,Debit
2024-01-04,Internet Recharge,Utilities,-8269,-8385955,Debit
2025-03-09,Medical Store,Health,-1007,-8386962,Debit
2025-04-23,FD Interest,Savings Interest,8945,-8378017,Credit
2024-06-07,FD Interest,Savings Interest,10146,-8367871,Credit
2024-09-18,Amazon Purchase,Shopping,-5617,-8373488,Debit
2024-06-12,Refund,Income,7931,-8365557,Credit
2025-03-28,Interest Credit,Savings Interest,16140,-8349417,Credit
2024-05-31,Petrol,Transport,-414,-8349831,Debit
2025-05-04,Uber Ride,Transport,-4487,-8354318,Debit
2024-01-25,UPI to Friend,Transfer,-469,-8354787,Debit
2025-05-14,UPI to Friend,Transfer,-2021,-8356808,Debit
2024-06-23,UPI to Friend,Transfer,-409,-8357217,Debit
2024-06-22,Bonus,Income,16826,-8340391,Credit
2024-05-14,Cash Deposit,Cash,-1319,-8341710,Debit
2025-05-10,FD Interest,Savings Interest,20149,-8321561,Credit
2024-06-29,Bonus,Income,28534,-8293027,Credit
2024-07-02,Electricity Bill,Utilities,-5062,-8298089,Debit
2025-04-08,Internet Recharge,Utilities,-1605,-8299694,Debit
2025-03-03,YouTube Premium,Entertainment,-4596,-8304290,Debit
2025-03-28,Received from Rahul,Transfer,-7169,-8311459,Debit
2024-07-31,Uber Ride,Transport,-217,-8311676,Debit
2024-10-26,ATM Withdrawal,Cash,-9373,-8321049,Debit
2024-12-05,Movie Tickets,Entertainment,-4257,-8325306,Debit
2024-07-28,FD Interest,Savings Interest,8980,-8316326,Credit
2025-01-21,UPI to Friend,Transfer,-1984,-8318310,Debit
2024-01-18,Train Ticket,Transport,-9343,-8327653,Debit
2024-07-14,Refund,Income,29403,-8298250,Credit
2024-04-17,Interest Credit,Savings Interest,23119,-8275131,Credit
2024-08-29,Freelance Payment,Income,15961,-8259170,Credit
2024-04-02,Medical Store,Health,-7129,-8266299,Debit
2025-05-08,YouTube Premium,Entertainment,-3662,-8269961,Debit
2024-03-03,Medical Store,Health,-2519,-8272480,Debit
2025-03-15,Train Ticket,Transport,-2929,-8275409,Debit
2024-08-16,Restaurant Bill,Food,-1270,-8276679,Debit
2024-04-16,ATM Withdrawal,Cash,-4872,-8281551,Debit
2024-04-06,Swiggy,Food,-5015,-8286566,Debit
2025-02-10,Water Bill,Utilities,-8809,-8295375,Debit
2025-03-20,Freelance Payment,Income,22293,-8273082,Credit
2025-04-14,Movie Tickets,Entertainment,-8248,-8281330,Debit
2025-02-22,Train Ticket,Transport,-9600,-8290930,Debit
2024-02-29,Internet Recharge,Utilities,-1934,-8292864,Debit
2025-02-27,Internet Recharge,Utilities,-9049,-8301913,Debit
2024-05-03,Interest Credit,Savings Interest,25392,-8276521,Credit
2025-04-28,ATM Withdrawal,Cash,-8329,-8284850,Debit
2024-12-18,Spotify,Entertainment,-3626,-8288476,Debit
2024-11-01,FD Interest,Savings Interest,19129,-8269347,Credit
2024-09-26,Bonus,Income,14918,-8254429,Credit
2024-04-12,Salary Credit,Income,24774,-8229655,Credit
2025-02-28,Water Bill,Utilities,-664,-8230319,Debit
2024-09-18,FD Interest,Savings Interest,19929,-8210390,Credit
2024-10-31,Electricity Bill,Utilities,-8696,-8219086,Debit
2024-06-30,YouTube Premium,Entertainment,-424,-8219510,Debit
2025-01-16,Freelance Payment,Income,1435,-8218075,Credit
2025-04-16,Petrol,Transport,-1496,-8219571,Debit
2024-01-21,Salary Credit,Income,2216,-8217355,Credit
2024-03-11,FD Interest,Savings Interest,28676,-8188679,Credit
2024-04-09,YouTube Premium,Entertainment,-1033,-8189712,Debit
2025-04-30,Doctor Visit,Health,-3861,-8193573,Debit
2024-11-27,Swiggy,Food,-2274,-8195847,Debit
2024-07-20,Doctor Visit,Health,-7836,-8203683,Debit
2024-12-01,Petrol,Transport,-5857,-8209540,Debit
2024-04-06,Bank Transfer,Transfer,-2212,-8211752,Debit
2024-04-09,Cafe Coffee Day,Food,-460,-8212212,Debit
2024-09-25,Train Ticket,Transport,-2175,-8214387,Debit
2024-12-13,Electricity Bill,Utilities,-9310,-8223697,Debit
2024-04-12,Train Ticket,Transport,-4843,-8228540,Debit
2025-01-19,Bank Transfer,Transfer,-6149,-8234689,Debit
2024-08-09,Interest Credit,Savings Interest,7334,-8227355,Credit
2024-07-01,Interest Credit,Savings Interest,4412,-8222943,Credit
2024-11-21,Train Ticket,Transport,-8384,-8231327,Debit
2024-06-03,Received from Rahul,Transfer,-1594,-8232921,Debit
2024-09-18,Train Ticket,Transport,-6208,-8239129,Debit
2024-03-14,Uber Ride,Transport,-8509,-8247638,Debit
2024-05-12,Uber Ride,Transport,-9506,-8257144,Debit
2024-07-22,Doctor Visit,Health,-7712,-8264856,Debit
2024-06-27,Swiggy,Food,-5809,-8270665,Debit
2024-03-21,ATM Withdrawal,Cash,-8601,-8279266,Debit
2024-03-20,Cafe Coffee Day,Food,-5343,-8284609,Debit
2024-07-19,Water Bill,Utilities,-1996,-8286605,Debit
2025-05-10,Restaurant Bill,Food,-3501,-8290106,Debit
2024-03-19,Medical Store,Health,-6708,-8296814,Debit
2024-12-10,Cash Deposit,Cash,-3082,-8299896,Debit
2024-02-18,Amazon Purchase,Shopping,-3875,-8303771,Debit
2025-04-02,Myntra Shopping,Shopping,-4092,-8307863,Debit
2024-02-20,Electronics,Shopping,-9653,-8317516,Debit
2025-03-20,Uber Ride,Transport,-8498,-8326014,Debit
2025-04-09,UPI to Friend,Transfer,-9367,-8335381,Debit
2024-09-24,UPI to Friend,Transfer,-6417,-8341798,Debit
2024-01-23,Amazon Purchase,Shopping,-6140,-8347938,Debit
2024-10-03,Restaurant Bill,Food,-9743,-8357681,Debit
2024-03-18,Interest Credit,Savings Interest,19939,-8337742,Credit
2024-11-06,Movie Tickets,Entertainment,-2234,-8339976,Debit
2024-01-12,Myntra Shopping,Shopping,-5592,-8345568,Debit
2025-02-19,Interest Credit,Savings Interest,27615,-8317953,Credit
2025-01-30,YouTube Premium,Entertainment,-4280,-8322233,Debit
2025-02-01,UPI to Friend,Transfer,-3675,-8325908,Debit
2024-09-12,Cash Deposit,Cash,-7171,-8333079,Debit
2024-05-26,UPI to Friend,Transfer,-9242,-8342321,Debit
2024-02-28,Cash Deposit,Cash,-2973,-8345294,Debit
2024-07-04,Electricity Bill,Utilities,-8997,-8354291,Debit
2024-08-02,Received from Rahul,Transfer,-4857,-8359148,Debit
2024-10-26,Restaurant Bill,Food,-8977,-8368125,Debit
2024-02-11,Refund,Income,10826,-8357299,Credit
2024-07-12,Myntra Shopping,Shopping,-5975,-8363274,Debit
2024-03-17,Petrol,Transport,-7249,-8370523,Debit
2025-03-21,Train Ticket,Transport,-175,-8370698,Debit
2024-04-17,Swiggy,Food,-7801,-8378499,Debit
2024-10-21,Spotify,Entertainment,-5543,-8384042,Debit
2024-05-11,Medical Store,Health,-3652,-8387694,Debit
2025-03-05,YouTube Premium,Entertainment,-9867,-8397561,Debit
2024-06-30,Internet Recharge,Utilities,-1019,-8398580,Debit
2024-11-10,Flipkart Order,Shopping,-2676,-8401256,Debit
2025-05-08,Interest Credit,Savings Interest,13831,-8387425,Credit
2024-10-17,Internet Recharge,Utilities,-4697,-8392122,Debit
2025-01-13,Interest Credit,Savings Interest,1119,-8391003,Credit
2024-01-09,Uber Ride,Transport,-7875,-8398878,Debit
2025-04-20,Medical Store,Health,-5012,-8403890,Debit
2024-01-16,Refund,Income,19317,-8384573,Credit
2024-10-06,Interest Credit,Savings Interest,1986,-8382587,Credit
2025-03-17,Cash Deposit,Cash,-8885,-8391472,Debit
2025-02-05,UPI to Friend,Transfer,-4034,-8395506,Debit
2024-12-02,Freelance Payment,Income,13416,-8382090,Credit
2025-04-01,Salary Credit,Income,9704,-8372386,Credit
2024-07-16,Cafe Coffee Day,Food,-2632,-8375018,Debit
2025-02-02,Refund,Income,3741,-8371277,Credit
2024-10-07,Spotify,Entertainment,-4117,-8375394,Debit
2025-03-10,Bank Transfer,Transfer,-6152,-8381546,Debit
2024-06-18,YouTube Premium,Entertainment,-6331,-8387877,Debit
2024-08-31,Train Ticket,Transport,-5368,-8393245,Debit
2025-02-08,Medical Store,Health,-1299,-8394544,Debit
2024-04-08,Swiggy,Food,-3642,-8398186,Debit
2024-11-14,Water Bill,Utilities,-8456,-8406642,Debit
2024-09-20,YouTube Premium,Entertainment,-161,-8406803,Debit
2024-11-09,Doctor Visit,Health,-2401,-8409204,Debit
2025-01-25,Freelance Payment,Income,13527,-8395677,Credit
2024-09-16,Cafe Coffee Day,Food,-7145,-8402822,Debit
2024-08-13,Myntra Shopping,Shopping,-6749,-8409571,Debit
2024-09-23,Train Ticket,Transport,-3485,-8413056,Debit
2024-05-28,Swiggy,Food,-5243,-8418299,Debit
2024-05-18,FD Interest,Savings Interest,1637,-8416662,Credit
2024-12-21,Uber Ride,Transport,-1494,-8418156,Debit
2024-05-03,Cash Deposit,Cash,-7528,-8425684,Debit
2025-02-16,Amazon Purchase,Shopping,-5717,-8431401,Debit
2025-05-06,FD Interest,Savings Interest,16138,-8415263,Credit
2024-05-02,Internet Recharge,Utilities,-1714,-8416977,Debit
2024-12-14,Doctor Visit,Health,-2799,-8419776,Debit
2024-12-03,FD Interest,Savings Interest,19706,-8400070,Credit
2024-12-25,Salary Credit,Income,29296,-8370774,Credit
2025-02-23,Flipkart Order,Shopping,-9609,-8380383,Debit
2025-01-25,Swiggy,Food,-4798,-8385181,Debit
2025-01-14,Amazon Purchase,Shopping,-1768,-8386949,Debit
2024-12-10,Movie Tickets,Entertainment,-976,-8387925,Debit
2024-04-18,Bonus,Income,2318,-8385607,Credit
2025-05-09,Received from Rahul,Transfer,-7473,-8393080,Debit
2024-01-09,Interest Credit,Savings Interest,2412,-8390668,Credit
2024-01-30,Refund,Income,14085,-8376583,Credit
2024-02-07,Cash Deposit,Cash,-5939,-8382522,Debit
2025-05-06,Cash Deposit,Cash,-3034,-8385556,Debit
2024-12-31,Swiggy,Food,-5288,-8390844,Debit
2024-04-08,Electricity Bill,Utilities,-733,-8391577,Debit
2024-11-28,Zomato Order,Food,-3302,-8394879,Debit
2024-03-28,Electricity Bill,Utilities,-8177,-8403056,Debit
2024-05-06,Bank Transfer,Transfer,-2308,-8405364,Debit
2024-02-16,Restaurant Bill,Food,-2266,-8407630,Debit
2024-10-18,Train Ticket,Transport,-912,-8408542,Debit
2024-10-13,Amazon Purchase,Shopping,-9616,-8418158,Debit
2025-04-13,Water Bill,Utilities,-7639,-8425797,Debit
2025-02-05,Zomato Order,Food,-4595,-8430392,Debit
2024-02-16,Petrol,Transport,-1955,-8432347,Debit
2025-01-31,Electricity Bill,Utilities,-1860,-8434207,Debit
2024-06-22,Interest Credit,Savings Interest,19711,-8414496,Credit
2024-06-13,Petrol,Transport,-575,-8415071,Debit
2024-01-12,Medical Store,Health,-3471,-8418542,Debit
2024-12-31,ATM Withdrawal,Cash,-6284,-8424826,Debit
2024-07-30,Train Ticket,Transport,-8861,-8433687,Debit
2025-03-08,Interest Credit,Savings Interest,21221,-8412466,Credit
2025-01-10,FD Interest,Savings Interest,7460,-8405006,Credit
2024-03-24,Freelance Payment,Income,5791,-8399215,Credit
2025-04-02,Freelance Payment,Income,3135,-8396080,Credit
2024-08-09,Cash Deposit,Cash,-2697,-8398777,Debit
2024-04-08,Doctor Visit,Health,-3106,-8401883,Debit
2024-04-25,Medical Store,Health,-5421,-8407304,Debit
2024-06-04,Myntra Shopping,Shopping,-7691,-8414995,Debit
2025-02-01,Amazon Purchase,Shopping,-8797,-8423792,Debit
2025-03-03,Internet Recharge,Utilities,-724,-8424516,Debit
2024-01-02,Medical Store,Health,-6980,-8431496,Debit
2024-06-12,Medical Store,Health,-6387,-8437883,Debit
2024-08-14,Zomato Order,Food,-2319,-8440202,Debit
2024-03-15,Bank Transfer,Transfer,-1566,-8441768,Debit
2025-03-30,Salary Credit,Income,3634,-8438134,Credit
2024-02-04,YouTube Premium,Entertainment,-387,-8438521,Debit
2024-02-15,Salary Credit,Income,9669,-8428852,Credit
2024-09-04,Cash Deposit,Cash,-4242,-8433094,Debit
2024-03-22,Medical Store,Health,-3297,-8436391,Debit
2024-01-05,Spotify,Entertainment,-6554,-8442945,Debit
2024-11-11,Medical Store,Health,-4134,-8447079,Debit
2025-02-28,Electricity Bill,Utilities,-285,-8447364,Debit
2025-01-10,Doctor Visit,Health,-9650,-8457014,Debit
2024-01-10,Spotify,Entertainment,-3647,-8460661,Debit
2024-10-07,ATM Withdrawal,Cash,-8585,-8469246,Debit
2024-08-20,Swiggy,Food,-3375,-8472621,Debit
2025-05-15,Medical Store,Health,-3029,-8475650,Debit
2024-06-23,Electronics,Shopping,-8105,-8483755,Debit
2024-03-18,ATM Withdrawal,Cash,-392,-8484147,Debit
2025-02-12,Refund,Income,8719,-8475428,Credit
2025-04-16,Myntra Shopping,Shopping,-7933,-8483361,Debit
2025-02-05,Electronics,Shopping,-7362,-8490723,Debit
2024-07-05,UPI to Friend,Transfer,-6218,-8496941,Debit
2025-03-07,Water Bill,Utilities,-3247,-8500188,Debit
2024-07-31,Medical Store,Health,-3220,-8503408,Debit
2024-06-04,UPI to Friend,Transfer,-7722,-8511130,Debit
2024-10-21,Electricity Bill,Utilities,-8437,-8519567,Debit
2024-09-08,Refund,Income,13015,-8506552,Credit
2024-08-10,Petrol,Transport,-3472,-8510024,Debit
2024-12-14,Internet Recharge,Utilities,-2484,-8512508,Debit
2024-03-29,Medical Store,Health,-5441,-8517949,Debit
2024-08-29,ATM Withdrawal,Cash,-1083,-8519032,Debit
2025-05-09,Restaurant Bill,Food,-6993,-8526025,Debit
2024-08-18,YouTube Premium,Entertainment,-5583,-8531608,Debit
2024-12-09,Cash Deposit,Cash,-8571,-8540179,Debit
2024-04-24,Movie Tickets,Entertainment,-1598,-8541777,Debit
2025-03-02,Zomato Order,Food,-4918,-8546695,Debit
2024-06-07,Doctor Visit,Health,-2507,-8549202,Debit
2024-12-06,Bank Transfer,Transfer,-9066,-8558268,Debit
2024-11-06,UPI to Friend,Transfer,-1103,-8559371,Debit
2024-11-03,Bank Transfer,Transfer,-3962,-8563333,Debit
2024-08-06,Bank Transfer,Transfer,-670,-8564003,Debit
2025-04-06,FD Interest,Savings Interest,23672,-8540331,Credit
2025-05-09,Doctor Visit,Health,-9386,-8549717,Debit
2024-12-28,Refund,Income,16907,-8532810,Credit
2024-06-07,Water Bill,Utilities,-3995,-8536805,Debit
2024-04-20,Electronics,Shopping,-2414,-8539219,Debit
2025-02-25,Medical Store,Health,-4370,-8543589,Debit
2025-01-20,Medical Store,Health,-1765,-8545354,Debit
2025-02-14,Uber Ride,Transport,-3622,-8548976,Debit
2024-02-12,Received from Rahul,Transfer,-2703,-8551679,Debit
2024-05-02,Electricity Bill,Utilities,-4311,-8555990,Debit
2024-11-23,Internet Recharge,Utilities,-2178,-8558168,Debit
2025-04-03,Petrol,Transport,-7741,-8565909,Debit
2025-05-14,Cafe Coffee Day,Food,-2203,-8568112,Debit
2024-02-26,FD Interest,Savings Interest,23626,-8544486,Credit
2025-01-08,YouTube Premium,Entertainment,-2160,-8546646,Debit
2025-03-14,Restaurant Bill,Food,-7724,-8554370,Debit
2024-06-20,ATM Withdrawal,Cash,-9813,-8564183,Debit
2025-02-21,Medical Store,Health,-3889,-8568072,Debit
2024-08-28,Interest Credit,Savings Interest,25582,-8542490,Credit
2024-09-14,Doctor Visit,Health,-4318,-8546808,Debit
2024-04-12,Interest Credit,Savings Interest,14599,-8532209,Credit
2024-12-15,Medical Store,Health,-7902,-8540111,Debit
2024-09-06,Internet Recharge,Utilities,-2203,-8542314,Debit
2024-02-29,Train Ticket,Transport,-2667,-8544981,Debit
2025-03-16,Amazon Purchase,Shopping,-7448,-8552429,Debit
2025-02-13,Spotify,Entertainment,-1627,-8554056,Debit
2024-06-09,Bonus,Income,12832,-8541224,Credit
2024-05-09,UPI to Friend,Transfer,-7249,-8548473,Debit
2024-02-15,FD Interest,Savings Interest,5181,-8543292,Credit
2024-05-07,Petrol,Transport,-6560,-8549852,Debit
2025-04-03,Interest Credit,Savings Interest,21845,-8528007,Credit
2024-08-31,Refund,Income,15539,-8512468,Credit
2024-02-16,Electricity Bill,Utilities,-5156,-8517624,Debit
2024-01-16,Medical Store,Health,-8182,-8525806,Debit
2024-11-04,Freelance Payment,Income,29314,-8496492,Credit
2024-04-14,Salary Credit,Income,4652,-8491840,Credit
2024-01-19,Uber Ride,Transport,-2430,-8494270,Debit
2024-10-11,Petrol,Transport,-2538,-8496808,Debit
2024-02-28,Freelance Payment,Income,26859,-8469949,Credit
2025-03-21,Received from Rahul,Transfer,-1525,-8471474,Debit
2025-01-26,Received from Rahul,Transfer,-1051,-8472525,Debit
2024-05-26,Movie Tickets,Entertainment,-8481,-8481006,Debit
2024-05-30,Train Ticket,Transport,-8228,-8489234,Debit
2025-03-18,Movie Tickets,Entertainment,-2004,-8491238,Debit
2024-06-27,Cash Deposit,Cash,-7904,-8499142,Debit
2025-01-12,Medical Store,Health,-234,-8499376,Debit
2024-01-14,Doctor Visit,Health,-2191,-8501567,Debit
2024-10-04,Uber Ride,Transport,-6901,-8508468,Debit
2024-04-06,Myntra Shopping,Shopping,-1567,-8510035,Debit
2024-11-28,Electronics,Shopping,-9495,-8519530,Debit
2024-09-15,Uber Ride,Transport,-3383,-8522913,Debit
2024-11-22,Flipkart Order,Shopping,-262,-8523175,Debit
2024-11-03,Freelance Payment,Income,21055,-8502120,Credit
2025-05-01,Train Ticket,Transport,-9460,-8511580,Debit
2024-02-19,Doctor Visit,Health,-6860,-8518440,Debit
2025-01-10,Cash Deposit,Cash,-1447,-8519887,Debit
2025-01-23,Freelance Payment,Income,22248,-8497639,Credit
2025-04-18,Salary Credit,Income,12859,-8484780,Credit
2024-12-05,Medical Store,Health,-1781,-8486561,Debit
2024-04-11,Myntra Shopping,Shopping,-4069,-8490630,Debit
2024-03-19,UPI to Friend,Transfer,-7299,-8497929,Debit
2024-08-21,Bank Transfer,Transfer,-5048,-8502977,Debit
2024-01-12,UPI to Friend,Transfer,-8359,-8511336,Debit
2024-08-03,ATM Withdrawal,Cash,-6830,-8518166,Debit
2025-01-02,Swiggy,Food,-7368,-8525534,Debit
2024-04-29,FD Interest,Savings Interest,19164,-8506370,Credit
2025-03-10,Spotify,Entertainment,-4418,-8510788,Debit
2025-02-13,Doctor Visit,Health,-2108,-8512896,Debit
2025-02-04,Uber Ride,Transport,-3002,-8515898,Debit
2024-07-14,Bank Transfer,Transfer,-1352,-8517250,Debit
2024-10-12,Uber Ride,Transport,-3816,-8521066,Debit
2024-10-18,Freelance Payment,Income,2505,-8518561,Credit
2024-06-13,Bank Transfer,Transfer,-104,-8518665,Debit
2024-10-13,Water Bill,Utilities,-8549,-8527214,Debit
2025-02-11,Movie Tickets,Entertainment,-1427,-8528641,Debit
2025-02-04,Flipkart Order,Shopping,-2730,-8531371,Debit
2024-07-11,Internet Recharge,Utilities,-1735,-8533106,Debit
2024-02-29,Swiggy,Food,-9539,-8542645,Debit
2024-06-11,Bonus,Income,10876,-8531769,Credit
2025-05-14,Water Bill,Utilities,-2923,-8534692,Debit
2024-06-12,Amazon Purchase,Shopping,-1254,-8535946,Debit
2024-03-22,Medical Store,Health,-2541,-8538487,Debit
2024-07-12,Medical Store,Health,-8897,-8547384,Debit
2024-05-20,Interest Credit,Savings Interest,22260,-8525124,Credit
2024-03-16,Medical Store,Health,-9750,-8534874,Debit
2024-07-16,Internet Recharge,Utilities,-4209,-8539083,Debit
2024-05-02,Internet Recharge,Utilities,-6629,-8545712,Debit
2024-06-13,Freelance Payment,Income,4098,-8541614,Credit
2025-02-10,Amazon Purchase,Shopping,-3407,-8545021,Debit
2024-03-27,Bonus,Income,29511,-8515510,Credit
2024-11-25,Doctor Visit,Health,-5072,-8520582,Debit
2024-03-02,Internet Recharge,Utilities,-2285,-8522867,Debit
2025-04-11,YouTube Premium,Entertainment,-6901,-8529768,Debit
2024-11-14,Electricity Bill,Utilities,-1357,-8531125,Debit
2024-04-04,Electricity Bill,Utilities,-8403,-8539528,Debit
2024-11-25,UPI to Friend,Transfer,-1870,-8541398,Debit
2024-01-19,Petrol,Transport,-8022,-8549420,Debit
2024-12-30,YouTube Premium,Entertainment,-4269,-8553689,Debit
2024-04-17,Cafe Coffee Day,Food,-2057,-8555746,Debit
2024-09-21,UPI to Friend,Transfer,-4186,-8559932,Debit
2025-02-28,Movie Tickets,Entertainment,-7247,-8567179,Debit
2024-07-15,Zomato Order,Food,-960,-8568139,Debit
2025-02-22,Cash Deposit,Cash,-4783,-8572922,Debit
2024-03-22,Doctor Visit,Health,-1006,-8573928,Debit
2024-01-18,Salary Credit,Income,25891,-8548037,Credit
2025-02-21,Movie Tickets,Entertainment,-2318,-8550355,Debit
2025-03-21,Medical Store,Health,-2070,-8552425,Debit
2024-12-15,UPI to Friend,Transfer,-8352,-8560777,Debit
2024-01-23,Spotify,Entertainment,-1494,-8562271,Debit
2025-02-01,Medical Store,Health,-1807,-8564078,Debit
2025-02-10,Refund,Income,2991,-8561087,Credit
2024-07-18,Zomato Order,Food,-6248,-8567335,Debit
2024-01-21,Electricity Bill,Utilities,-3977,-8571312,Debit
2024-01-17,Movie Tickets,Entertainment,-8753,-8580065,Debit
2024-05-22,Interest Credit,Savings Interest,4338,-8575727,Credit
2024-02-22,Petrol,Transport,-7199,-8582926,Debit
2024-04-15,UPI to Friend,Transfer,-6649,-8589575,Debit
2025-04-05,Train Ticket,Transport,-6594,-8596169,Debit
2025-04-21,Zomato Order,Food,-194,-8596363,Debit
2025-04-09,Swiggy,Food,-3238,-8599601,Debit
2024-09-28,Train Ticket,Transport,-5795,-8605396,Debit
2025-03-28,Petrol,Transport,-172,-8605568,Debit
2024-03-06,FD Interest,Savings Interest,17782,-8587786,Credit
2024-03-11,Swiggy,Food,-5272,-8593058,Debit
2024-01-19,Water Bill,Utilities,-2752,-8595810,Debit
2024-06-25,Cash Deposit,Cash,-4887,-8600697,Debit
2024-12-15,Uber Ride,Transport,-3774,-8604471,Debit
2024-05-09,Salary Credit,Income,21400,-8583071,Credit
2024-12-14,Uber Ride,Transport,-296,-8583367,Debit
2024-09-09,Interest Credit,Savings Interest,17086,-8566281,Credit
2025-01-31,Electronics,Shopping,-5281,-8571562,Debit
2024-12-04,ATM Withdrawal,Cash,-7225,-8578787,Debit
2024-05-10,Movie Tickets,Entertainment,-1032,-8579819,Debit
2024-03-22,Medical Store,Health,-7541,-8587360,Debit
2024-09-02,Cafe Coffee Day,Food,-4790,-8592150,Debit
2024-10-07,Internet Recharge,Utilities,-3558,-8595708,Debit
2024-06-10,Spotify,Entertainment,-5873,-8601581,Debit
2024-08-09,Freelance Payment,Income,28063,-8573518,Credit
2024-02-21,Medical Store,Health,-9149,-8582667,Debit
2024-01-17,Internet Recharge,Utilities,-5480,-8588147,Debit
2024-11-19,Swiggy,Food,-9672,-8597819,Debit
2024-06-26,Petrol,Transport,-8670,-8606489,Debit
2025-01-23,Spotify,Entertainment,-6095,-8612584,Debit
2024-09-04,Petrol,Transport,-4601,-8617185,Debit
2024-12-02,Interest Credit,Savings Interest,29465,-8587720,Credit
2024-11-23,Bank Transfer,Transfer,-2187,-8589907,Debit
2024-08-04,Bonus,Income,8089,-8581818,Credit
2025-02-02,Spotify,Entertainment,-8332,-8590150,Debit
2025-02-15,Received from Rahul,Transfer,-5222,-8595372,Debit
2024-03-30,FD Interest,Savings Interest,7068,-8588304,Credit
2024-02-20,Movie Tickets,Entertainment,-5184,-8593488,Debit
2025-05-14,Freelance Payment,Income,17275,-8576213,Credit
2024-07-19,UPI to Friend,Transfer,-5909,-8582122,Debit
2024-07-17,FD Interest,Savings Interest,6071,-8576051,Credit
2024-02-20,Zomato Order,Food,-9451,-8585502,Debit
2024-12-24,Interest Credit,Savings Interest,19091,-8566411,Credit
2024-03-12,Electronics,Shopping,-1430,-8567841,Debit
2025-03-24,Freelance Payment,Income,16837,-8551004,Credit
2025-01-14,Amazon Purchase,Shopping,-9212,-8560216,Debit
2025-01-11,Doctor Visit,Health,-5198,-8565414,Debit
2025-04-20,Bank Transfer,Transfer,-5313,-8570727,Debit
2024-04-01,Cash Deposit,Cash,-3760,-8574487,Debit
2024-11-18,Spotify,Entertainment,-956,-8575443,Debit
2024-03-01,Amazon Purchase,Shopping,-3490,-8578933,Debit
2024-01-17,Water Bill,Utilities,-6829,-8585762,Debit
2024-06-23,ATM Withdrawal,Cash,-908,-8586670,Debit
2024-08-22,Movie Tickets,Entertainment,-5398,-8592068,Debit
2024-09-19,Uber Ride,Transport,-3940,-8596008,Debit
2025-03-09,Refund,Income,12711,-8583297,Credit
2024-02-05,Received from Rahul,Transfer,-453,-8583750,Debit
2025-05-12,Medical Store,Health,-5486,-8589236,Debit
2024-03-06,Restaurant Bill,Food,-9728,-8598964,Debit
2025-02-24,Interest Credit,Savings Interest,12471,-8586493,Credit
2024-06-12,Doctor Visit,Health,-8895,-8595388,Debit
2024-03-23,Salary Credit,Income,19837,-8575551,Credit
2025-01-21,UPI to Friend,Transfer,-9432,-8584983,Debit
2024-06-18,Electricity Bill,Utilities,-3169,-8588152,Debit
2024-09-27,Movie Tickets,Entertainment,-3169,-8591321,Debit
2024-01-20,Medical Store,Health,-4078,-8595399,Debit
2024-08-02,UPI to Friend,Transfer,-6704,-8602103,Debit
2025-01-19,Myntra Shopping,Shopping,-8937,-8611040,Debit
2024-12-09,Cafe Coffee Day,Food,-1286,-8612326,Debit
2025-04-13,Petrol,Transport,-5362,-8617688,Debit
2024-11-30,Train Ticket,Transport,-6453,-8624141,Debit
2025-03-02,Interest Credit,Savings Interest,29989,-8594152,Credit
2025-04-08,Medical Store,Health,-3418,-8597570,Debit
2025-03-02,Doctor Visit,Health,-5018,-8602588,Debit
2024-01-23,FD Interest,Savings Interest,16904,-8585684,Credit
2024-10-31,ATM Withdrawal,Cash,-7799,-8593483,Debit
2024-08-27,Received from Rahul,Transfer,-964,-8594447,Debit
2024-02-20,Water Bill,Utilities,-8585,-8603032,Debit
2025-01-19,Petrol,Transport,-9228,-8612260,Debit
2025-04-12,Interest Credit,Savings Interest,3870,-8608390,Credit
2025-02-26,Cafe Coffee Day,Food,-9145,-8617535,Debit
2024-02-04,Medical Store,Health,-1948,-8619483,Debit
2024-07-11,Amazon Purchase,Shopping,-9451,-8628934,Debit
2025-04-17,Cash Deposit,Cash,-1034,-8629968,Debit
2024-01-16,Cash Deposit,Cash,-143,-8630111,Debit
2024-07-21,Bonus,Income,12498,-8617613,Credit
2025-04-23,Received from Rahul,Transfer,-7125,-8624738,Debit
2024-02-21,Uber Ride,Transport,-9369,-8634107,Debit
2025-01-11,Train Ticket,Transport,-1634,-8635741,Debit
2024-02-24,YouTube Premium,Entertainment,-3126,-8638867,Debit
2025-02-28,FD Interest,Savings Interest,10384,-8628483,Credit
2024-06-21,Spotify,Entertainment,-7478,-8635961,Debit
2024-05-17,Train Ticket,Transport,-4685,-8640646,Debit
2024-12-27,Electronics,Shopping,-7860,-8648506,Debit
2024-03-05,ATM Withdrawal,Cash,-2050,-8650556,Debit
2024-11-21,Medical Store,Health,-1459,-8652015,Debit
2025-04-30,Zomato Order,Food,-7916,-8659931,Debit
2024-04-20,Flipkart Order,Shopping,-1865,-8661796,Debit
2025-04-25,ATM Withdrawal,Cash,-6243,-8668039,Debit
2024-05-28,Uber Ride,Transport,-6398,-8674437,Debit
2024-02-04,Electricity Bill,Utilities,-4782,-8679219,Debit
2024-06-02,Salary Credit,Income,16334,-8662885,Credit
2024-07-22,Bonus,Income,2951,-8659934,Credit
2024-09-25,Medical Store,Health,-8398,-8668332,Debit
2024-07-17,Medical Store,Health,-3455,-8671787,Debit
2024-10-06,Cash Deposit,Cash,-2940,-8674727,Debit
2024-10-27,Medical Store,Health,-2871,-8677598,Debit
2024-07-07,Spotify,Entertainment,-8782,-8686380,Debit
2024-04-28,Refund,Income,9102,-8677278,Credit
2025-04-30,Electricity Bill,Utilities,-2023,-8679301,Debit
2024-02-11,Uber Ride,Transport,-9604,-8688905,Debit
2024-11-23,Movie Tickets,Entertainment,-1830,-8690735,Debit
2025-01-08,Salary Credit,Income,825,-8689910,Credit
2024-07-03,Salary Credit,Income,9364,-8680546,Credit
2024-11-09,ATM Withdrawal,Cash,-4933,-8685479,Debit
2024-08-30,Electricity Bill,Utilities,-3419,-8688898,Debit
2025-01-22,Uber Ride,Transport,-3016,-8691914,Debit
2024-01-03,Doctor Visit,Health,-2151,-8694065,Debit
2024-07-21,Medical Store,Health,-8502,-8702567,Debit
2024-10-24,Cash Deposit,Cash,-2830,-8705397,Debit
2024-06-10,Movie Tickets,Entertainment,-1199,-8706596,Debit
2024-04-24,Refund,Income,24157,-8682439,Credit
2024-01-14,Amazon Purchase,Shopping,-4851,-8687290,Debit
2024-10-31,Water Bill,Utilities,-8342,-8695632,Debit
2025-01-10,Water Bill,Utilities,-8012,-8703644,Debit
2024-10-30,FD Interest,Savings Interest,27789,-8675855,Credit
2024-03-20,Doctor Visit,Health,-8599,-8684454,Debit
2024-05-15,Swiggy,Food,-2795,-8687249,Debit
2024-06-19,Train Ticket,Transport,-8927,-8696176,Debit
2025-05-01,Cafe Coffee Day,Food,-2572,-8698748,Debit
2024-04-04,Medical Store,Health,-7524,-8706272,Debit
2024-07-28,YouTube Premium,Entertainment,-9512,-8715784,Debit
2024-08-15,UPI to Friend,Transfer,-4520,-8720304,Debit
2024-12-12,Myntra Shopping,Shopping,-4097,-8724401,Debit
2025-04-19,Medical Store,Health,-8861,-8733262,Debit
2025-02-27,ATM Withdrawal,Cash,-1204,-8734466,Debit
2024-06-26,Cash Deposit,Cash,-8636,-8743102,Debit
2024-08-05,Myntra Shopping,Shopping,-4847,-8747949,Debit
2024-04-02,Salary Credit,Income,15790,-8732159,Credit
2024-09-15,UPI to Friend,Transfer,-5909,-8738068,Debit
2024-08-28,Train Ticket,Transport,-7944,-8746012,Debit
2024-04-29,Train Ticket,Transport,-2529,-8748541,Debit
2024-01-28,Medical Store,Health,-578,-8749119,Debit
2024-01-13,Electricity Bill,Utilities,-4471,-8753590,Debit
2025-04-05,Petrol,Transport,-351,-8753941,Debit
2024-03-07,Water Bill,Utilities,-7503,-8761444,Debit
2024-11-18,Doctor Visit,Health,-1956,-8763400,Debit
2024-12-30,Electronics,Shopping,-509,-8763909,Debit
2024-04-25,Petrol,Transport,-8135,-8772044,Debit
2025-03-27,Water Bill,Utilities,-2713,-8774757,Debit
2024-08-16,Medical Store,Health,-4147,-8778904,Debit
2025-02-18,Electricity Bill,Utilities,-2695,-8781599,Debit
2025-03-26,Amazon Purchase,Shopping,-6613,-8788212,Debit
2025-04-11,Cash Deposit,Cash,-8203,-8796415,Debit
2024-10-16,Freelance Payment,Income,21785,-8774630,Credit
2024-06-09,Zomato Order,Food,-6139,-8780769,Debit
2025-02-28,Flipkart Order,Shopping,-4250,-8785019,Debit
2024-04-30,Interest Credit,Savings Interest,4251,-8780768,Credit
2025-02-27,Flipkart Order,Shopping,-504,-8781272,Debit
2025-04-13,Electronics,Shopping,-3323,-8784595,Debit
2024-01-13,Amazon Purchase,Shopping,-3197,-8787792,Debit
2025-01-05,Salary Credit,Income,9416,-8778376,Credit
2024-10-26,ATM Withdrawal,Cash,-7837,-8786213,Debit
2024-08-19,Petrol,Transport,-7920,-8794133,Debit
2025-03-19,Uber Ride,Transport,-3700,-8797833,Debit
2024-11-29,FD Interest,Savings Interest,13935,-8783898,Credit
2024-09-24,Train Ticket,Transport,-1009,-8784907,Debit
2024-07-06,Petrol,Transport,-2202,-8787109,Debit
2024-10-02,Cash Deposit,Cash,-8025,-8795134,Debit
2024-11-14,Bonus,Income,15737,-8779397,Credit
2025-03-08,Electronics,Shopping,-2027,-8781424,Debit
2024-08-28,Cash Deposit,Cash,-5787,-8787211,Debit
2024-03-18,Water Bill,Utilities,-7834,-8795045,Debit
2024-06-22,Internet Recharge,Utilities,-544,-8795589,Debit
2025-03-08,ATM Withdrawal,Cash,-9487,-8805076,Debit
2024-05-17,Myntra Shopping,Shopping,-748,-8805824,Debit
2025-02-12,Bonus,Income,2263,-8803561,Credit
2024-06-13,Restaurant Bill,Food,-9860,-8813421,Debit
2025-02-17,Electricity Bill,Utilities,-1408,-8814829,Debit
2024-01-18,Electronics,Shopping,-6972,-8821801,Debit
2025-04-23,Cash Deposit,Cash,-7236,-8829037,Debit
2024-06-24,Myntra Shopping,Shopping,-3962,-8832999,Debit
2024-05-21,YouTube Premium,Entertainment,-6324,-8839323,Debit
2024-01-03,Medical Store,Health,-9855,-8849178,Debit
2024-03-10,Electronics,Shopping,-2021,-8851199,Debit
2024-04-24,Flipkart Order,Shopping,-8625,-8859824,Debit
2024-04-21,UPI to Friend,Transfer,-3592,-8863416,Debit
2024-12-02,Refund,Income,23331,-8840085,Credit
2024-09-29,Uber Ride,Transport,-1111,-8841196,Debit
2025-02-26,Cafe Coffee Day,Food,-4909,-8846105,Debit
2025-04-30,Bank Transfer,Transfer,-7236,-8853341,Debit
2025-04-29,Doctor Visit,Health,-4993,-8858334,Debit
2024-01-20,Refund,Income,27070,-8831264,Credit
2024-07-24,ATM Withdrawal,Cash,-6092,-8837356,Debit
2024-03-10,Cafe Coffee Day,Food,-6333,-8843689,Debit
2024-06-16,Spotify,Entertainment,-980,-8844669,Debit
2024-10-04,Flipkart Order,Shopping,-482,-8845151,Debit
2024-04-25,Cash Deposit,Cash,-5756,-8850907,Debit
2024-01-22,Cash Deposit,Cash,-1665,-8852572,Debit
2024-12-02,Interest Credit,Savings Interest,3025,-8849547,Credit
2024-06-01,Bonus,Income,25827,-8823720,Credit
2024-12-10,Bank Transfer,Transfer,-9986,-8833706,Debit
2024-11-17,FD Interest,Savings Interest,12981,-8820725,Credit
2024-07-04,Interest Credit,Savings Interest,25025,-8795700,Credit
2024-03-06,Bank Transfer,Transfer,-6658,-8802358,Debit
2024-03-05,YouTube Premium,Entertainment,-5532,-8807890,Debit
2025-03-04,Water Bill,Utilities,-671,-8808561,Debit
2025-01-04,Interest Credit,Savings Interest,11192,-8797369,Credit
2025-03-22,YouTube Premium,Entertainment,-6573,-8803942,Debit
2024-01-05,Zomato Order,Food,-9918,-8813860,Debit
2024-02-23,FD Interest,Savings Interest,1467,-8812393,Credit
2024-10-26,ATM Withdrawal,Cash,-9166,-8821559,Debit
2025-03-21,Movie Tickets,Entertainment,-540,-8822099,Debit
2024-10-25,Received from Rahul,Transfer,-8350,-8830449,Debit
2024-05-04,Salary Credit,Income,8004,-8822445,Credit
2025-03-14,Flipkart Order,Shopping,-2185,-8824630,Debit
2024-10-21,Medical Store,Health,-2613,-8827243,Debit
2024-08-30,Uber Ride,Transport,-7642,-8834885,Debit
2024-09-21,ATM Withdrawal,Cash,-5590,-8840475,Debit
2024-09-06,FD Interest,Savings Interest,21463,-8819012,Credit
2024-03-20,Doctor Visit,Health,-2773,-8821785,Debit
2025-01-23,Doctor Visit,Health,-737,-8822522,Debit
2025-04-13,Cash Deposit,Cash,-8691,-8831213,Debit
2024-01-01,Bank Transfer,Transfer,-7150,-8838363,Debit
2025-05-11,Interest Credit,Savings Interest,8805,-8829558,Credit
2025-02-13,Doctor Visit,Health,-8773,-8838331,Debit
2024-12-07,ATM Withdrawal,Cash,-5408,-8843739,Debit
2024-11-25,Myntra Shopping,Shopping,-8306,-8852045,Debit
2024-12-01,Refund,Income,17000,-8835045,Credit
2025-03-12,Doctor Visit,Health,-8480,-8843525,Debit
2024-08-08,Zomato Order,Food,-1319,-8844844,Debit
2025-01-04,Interest Credit,Savings Interest,26721,-8818123,Credit
2025-04-16,Myntra Shopping,Shopping,-6648,-8824771,Debit
2024-02-05,Medical Store,Health,-8046,-8832817,Debit
2025-03-17,Flipkart Order,Shopping,-9478,-8842295,Debit
2024-08-13,Amazon Purchase,Shopping,-8680,-8850975,Debit
2024-03-19,ATM Withdrawal,Cash,-5409,-8856384,Debit
2024-06-02,Spotify,Entertainment,-4123,-8860507,Debit
2024-08-21,ATM Withdrawal,Cash,-3723,-8864230,Debit
2024-03-22,Doctor Visit,Health,-1971,-8866201,Debit
2024-09-21,Doctor Visit,Health,-310,-8866511,Debit
2024-12-29,YouTube Premium,Entertainment,-6992,-8873503,Debit
2024-12-05,ATM Withdrawal,Cash,-4058,-8877561,Debit
2024-06-07,Medical Store,Health,-4529,-8882090,Debit
2024-12-23,Doctor Visit,Health,-7441,-8889531,Debit
2024-05-30,ATM Withdrawal,Cash,-680,-8890211,Debit
2024-05-20,FD Interest,Savings Interest,14784,-8875427,Credit
2024-07-18,Received from Rahul,Transfer,-5887,-8881314,Debit
2024-01-31,YouTube Premium,Entertainment,-3536,-8884850,Debit
2025-02-01,Flipkart Order,Shopping,-6092,-8890942,Debit
2025-02-03,Petrol,Transport,-7853,-8898795,Debit
2025-05-07,FD Interest,Savings Interest,20348,-8878447,Credit
2024-03-09,Train Ticket,Transport,-2072,-8880519,Debit
2024-09-09,Zomato Order,Food,-8582,-8889101,Debit
2025-04-21,Swiggy,Food,-260,-8889361,Debit
2024-03-01,Train Ticket,Transport,-8490,-8897851,Debit
2024-03-09,Refund,Income,6781,-8891070,Credit
2024-05-26,Restaurant Bill,Food,-9133,-8900203,Debit
2024-05-15,Amazon Purchase,Shopping,-3269,-8903472,Debit
2024-01-15,Doctor Visit,Health,-4590,-8908062,Debit
2025-03-18,Cash Deposit,Cash,-2345,-8910407,Debit
2024-10-04,Zomato Order,Food,-9296,-8919703,Debit
2025-04-07,Interest Credit,Savings Interest,15217,-8904486,Credit
2025-02-10,Swiggy,Food,-1486,-8905972,Debit
2024-08-30,Interest Credit,Savings Interest,4066,-8901906,Credit
2024-03-13,Medical Store,Health,-539,-8902445,Debit
2024-08-08,Bonus,Income,13173,-8889272,Credit
2025-04-22,Doctor Visit,Health,-7978,-8897250,Debit
2024-01-31,Interest Credit,Savings Interest,23332,-8873918,Credit
2024-05-20,Bonus,Income,8789,-8865129,Credit
2024-12-30,Salary Credit,Income,5085,-8860044,Credit
2024-12-07,Interest Credit,Savings Interest,7973,-8852071,Credit
2024-01-02,Internet Recharge,Utilities,-6868,-8858939,Debit
2025-01-19,Received from Rahul,Transfer,-7639,-8866578,Debit
2024-09-24,Cash Deposit,Cash,-4307,-8870885,Debit
2024-01-06,Freelance Payment,Income,24666,-8846219,Credit
2024-05-07,Refund,Income,21253,-8824966,Credit
2025-02-17,Interest Credit,Savings Interest,19745,-8805221,Credit
2024-01-31,FD Interest,Savings Interest,1735,-8803486,Credit
2024-07-07,Train Ticket,Transport,-7175,-8810661,Debit
2024-10-20,Flipkart Order,Shopping,-2869,-8813530,Debit
2024-09-28,Cafe Coffee Day,Food,-2626,-8816156,Debit
2024-11-29,Cafe Coffee Day,Food,-9259,-8825415,Debit
2025-04-15,Uber Ride,Transport,-3328,-8828743,Debit
2024-04-12,Internet Recharge,Utilities,-5000,-8833743,Debit
2024-03-04,Flipkart Order,Shopping,-3049,-8836792,Debit
2024-11-11,Bonus,Income,19623,-8817169,Credit
2024-02-10,Train Ticket,Transport,-8248,-8825417,Debit
2024-07-24,Spotify,Entertainment,-7630,-8833047,Debit
2024-12-13,Train Ticket,Transport,-9268,-8842315,Debit
2024-01-26,Received from Rahul,Transfer,-491,-8842806,Debit
2025-05-01,Train Ticket,Transport,-8296,-8851102,Debit
2025-04-22,FD Interest,Savings Interest,25065,-8826037,Credit
2024-11-08,Spotify,Entertainment,-9727,-8835764,Debit
2025-02-27,Electronics,Shopping,-3825,-8839589,Debit
2025-01-10,Cafe Coffee Day,Food,-7875,-8847464,Debit
2025-05-09,Movie Tickets,Entertainment,-7006,-8854470,Debit
2024-02-09,Spotify,Entertainment,-6542,-8861012,Debit
2024-12-30,UPI to Friend,Transfer,-7701,-8868713,Debit
2024-11-25,Interest Credit,Savings Interest,6434,-8862279,Credit
2025-05-09,Flipkart Order,Shopping,-1395,-8863674,Debit
2024-07-11,Spotify,Entertainment,-5472,-8869146,Debit
2024-12-11,ATM Withdrawal,Cash,-5520,-8874666,Debit
2024-05-22,Electronics,Shopping,-997,-8875663,Debit
2024-10-29,Interest Credit,Savings Interest,5705,-8869958,Credit
2024-08-14,Medical Store,Health,-8852,-8878810,Debit
2025-02-23,Interest Credit,Savings Interest,5761,-8873049,Credit
2024-01-12,Movie Tickets,Entertainment,-4965,-8878014,Debit
2024-07-13,Cash Deposit,Cash,-2445,-8880459,Debit
2025-03-13,ATM Withdrawal,Cash,-9177,-8889636,Debit
2024-11-03,Spotify,Entertainment,-3117,-8892753,Debit
2024-04-29,Electricity Bill,Utilities,-3133,-8895886,Debit
2025-03-11,UPI to Friend,Transfer,-9428,-8905314,Debit
2025-03-22,Uber Ride,Transport,-5673,-8910987,Debit
2024-05-23,Electricity Bill,Utilities,-5173,-8916160,Debit
2024-10-22,UPI to Friend,Transfer,-3961,-8920121,Debit
2024-05-15,Movie Tickets,Entertainment,-9179,-8929300,Debit
2025-03-10,Train Ticket,Transport,-3683,-8932983,Debit
2024-08-24,Petrol,Transport,-7519,-8940502,Debit
2025-04-26,Train Ticket,Transport,-7521,-8948023,Debit
2025-02-17,Cash Deposit,Cash,-7932,-8955955,Debit
2024-06-05,Electricity Bill,Utilities,-4852,-8960807,Debit
2025-03-15,Salary Credit,Income,14363,-8946444,Credit
2025-02-03,YouTube Premium,Entertainment,-5269,-8951713,Debit
2024-08-14,Cash Deposit,Cash,-6844,-8958557,Debit
2024-03-25,Myntra Shopping,Shopping,-3175,-8961732,Debit
2024-07-29,FD Interest,Savings Interest,18533,-8943199,Credit
2024-06-25,Received from Rahul,Transfer,-2425,-8945624,Debit
2024-06-27,Interest Credit,Savings Interest,27405,-8918219,Credit
2024-07-03,Cash Deposit,Cash,-6838,-8925057,Debit
2024-01-18,Refund,Income,28628,-8896429,Credit
2024-11-11,Amazon Purchase,Shopping,-9295,-8905724,Debit
2024-02-15,FD Interest,Savings Interest,25168,-8880556,Credit
2025-03-03,Medical Store,Health,-6030,-8886586,Debit
2024-06-27,Zomato Order,Food,-8576,-8895162,Debit
2024-05-12,Medical Store,Health,-4875,-8900037,Debit
2024-07-05,Doctor Visit,Health,-3438,-8903475,Debit
2024-01-13,Cafe Coffee Day,Food,-7380,-8910855,Debit
2024-11-17,Restaurant Bill,Food,-2460,-8913315,Debit
2024-07-22,Doctor Visit,Health,-2366,-8915681,Debit
2025-04-17,Received from Rahul,Transfer,-9273,-8924954,Debit
2025-01-22,Interest Credit,Savings Interest,12479,-8912475,Credit
2024-02-02,Internet Recharge,Utilities,-9521,-8921996,Debit
2024-03-15,UPI to Friend,Transfer,-8259,-8930255,Debit
2024-09-25,Swiggy,Food,-8286,-8938541,Debit
2025-03-31,UPI to Friend,Transfer,-3420,-8941961,Debit
2024-09-16,YouTube Premium,Entertainment,-9644,-8951605,Debit
2025-04-04,Petrol,Transport,-5496,-8957101,Debit
2025-03-10,Uber Ride,Transport,-9594,-8966695,Debit
2024-10-20,Bank Transfer,Transfer,-3967,-8970662,Debit
2025-02-13,Flipkart Order,Shopping,-8050,-8978712,Debit
2024-12-10,Interest Credit,Savings Interest,28896,-8949816,Credit
2024-07-09,Restaurant Bill,Food,-5876,-8955692,Debit
2024-03-21,Amazon Purchase,Shopping,-3642,-8959334,Debit
2024-12-22,Train Ticket,Transport,-4937,-8964271,Debit
2024-05-05,ATM Withdrawal,Cash,-7245,-8971516,Debit
2025-02-12,Medical Store,Health,-2556,-8974072,Debit
2025-03-10,Received from Rahul,Transfer,-850,-8974922,Debit
2025-04-02,Electronics,Shopping,-6879,-8981801,Debit
2024-01-16,Medical Store,Health,-6614,-8988415,Debit
2024-08-02,Medical Store,Health,-3136,-8991551,Debit
2024-10-16,Doctor Visit,Health,-5517,-8997068,Debit
2025-03-17,Interest Credit,Savings Interest,18253,-8978815,Credit
2024-08-22,Salary Credit,Income,7242,-8971573,Credit
2025-03-28,Salary Credit,Income,15892,-8955681,Credit
2024-03-13,ATM Withdrawal,Cash,-1894,-8957575,Debit
2024-07-15,Cash Deposit,Cash,-501,-8958076,Debit
2024-07-10,Received from Rahul,Transfer,-9379,-8967455,Debit
2024-10-16,Doctor Visit,Health,-1526,-8968981,Debit
2024-08-12,Cash Deposit,Cash,-9178,-8978159,Debit
2024-06-01,Electricity Bill,Utilities,-9852,-8988011,Debit
2024-07-06,UPI to Friend,Transfer,-264,-8988275,Debit
2024-01-31,YouTube Premium,Entertainment,-4014,-8992289,Debit
2025-01-08,Myntra Shopping,Shopping,-8342,-9000631,Debit
2025-04-25,Myntra Shopping,Shopping,-6720,-9007351,Debit
2024-07-14,Salary Credit,Income,22775,-8984576,Credit
2024-01-06,Electronics,Shopping,-7273,-8991849,Debit
2024-12-30,FD Interest,Savings Interest,2558,-8989291,Credit
2024-02-06,Refund,Income,12751,-8976540,Credit
2024-12-30,Movie Tickets,Entertainment,-3765,-8980305,Debit
2024-04-25,Electricity Bill,Utilities,-7884,-8988189,Debit
2024-05-11,YouTube Premium,Entertainment,-5952,-8994141,Debit
2024-04-26,UPI to Friend,Transfer,-9403,-9003544,Debit
2024-09-29,Electricity Bill,Utilities,-3463,-9007007,Debit
2024-01-15,Train Ticket,Transport,-8941,-9015948,Debit
2024-05-28,ATM Withdrawal,Cash,-8274,-9024222,Debit
2024-03-15,Petrol,Transport,-7061,-9031283,Debit
2024-10-18,Train Ticket,Transport,-6568,-9037851,Debit
2024-03-23,Train Ticket,Transport,-6797,-9044648,Debit
2025-03-12,Flipkart Order,Shopping,-6007,-9050655,Debit
2024-02-16,Internet Recharge,Utilities,-4684,-9055339,Debit
2024-09-15,ATM Withdrawal,Cash,-2619,-9057958,Debit
2025-04-15,UPI to Friend,Transfer,-4096,-9062054,Debit
2024-03-05,FD Interest,Savings Interest,19469,-9042585,Credit
2025-04-30,Flipkart Order,Shopping,-1254,-9043839,Debit
2024-08-07,ATM Withdrawal,Cash,-2476,-9046315,Debit
2024-10-17,Doctor Visit,Health,-8551,-9054866,Debit
2024-06-10,Water Bill,Utilities,-131,-9054997,Debit
2024-09-25,Movie Tickets,Entertainment,-5969,-9060966,Debit
2025-02-04,Swiggy,Food,-9217,-9070183,Debit
2024-05-03,Medical Store,Health,-6329,-9076512,Debit
2024-03-30,Electricity Bill,Utilities,-1872,-9078384,Debit
2025-04-30,Interest Credit,Savings Interest,26475,-9051909,Credit
2024-08-28,ATM Withdrawal,Cash,-1259,-9053168,Debit
2024-12-19,Uber Ride,Transport,-9027,-9062195,Debit
2025-04-02,Bank Transfer,Transfer,-537,-9062732,Debit
2024-08-05,Train Ticket,Transport,-8355,-9071087,Debit
2024-07-05,Refund,Income,11559,-9059528,Credit
2024-01-24,Medical Store,Health,-8777,-9068305,Debit
2024-10-15,Movie Tickets,Entertainment,-9348,-9077653,Debit
2025-02-14,Movie Tickets,Entertainment,-1927,-9079580,Debit
2024-10-12,Cash Deposit,Cash,-3990,-9083570,Debit
2025-03-14,Zomato Order,Food,-2758,-9086328,Debit
2024-02-29,Interest Credit,Savings Interest,8060,-9078268,Credit
2024-12-29,FD Interest,Savings Interest,4994,-9073274,Credit
2024-01-13,Interest Credit,Savings Interest,9295,-9063979,Credit
2024-02-01,Freelance Payment,Income,14022,-9049957,Credit
2024-10-25,Swiggy,Food,-8006,-9057963,Debit
2025-05-09,Internet Recharge,Utilities,-5909,-9063872,Debit
2025-05-10,UPI to Friend,Transfer,-2345,-9066217,Debit
2024-02-18,Train Ticket,Transport,-244,-9066461,Debit
2024-12-30,Spotify,Entertainment,-5614,-9072075,Debit
2024-11-06,Uber Ride,Transport,-6583,-9078658,Debit
2025-01-24,Uber Ride,Transport,-2996,-9081654,Debit
2025-02-23,Spotify,Entertainment,-3539,-9085193,Debit
2025-03-27,FD Interest,Savings Interest,3303,-9081890,Credit
2024-05-07,Salary Credit,Income,24704,-9057186,Credit
2025-04-17,FD Interest,Savings Interest,1475,-9055711,Credit
2025-04-29,UPI to Friend,Transfer,-8477,-9064188,Debit
2024-12-27,Restaurant Bill,Food,-2986,-9067174,Debit
2024-03-10,Bank Transfer,Transfer,-6836,-9074010,Debit
2025-04-26,Interest Credit,Savings Interest,22942,-9051068,Credit
2024-03-29,Electricity Bill,Utilities,-7168,-9058236,Debit
2025-01-21,YouTube Premium,Entertainment,-5067,-9063303,Debit
2025-03-16,Cash Deposit,Cash,-9044,-9072347,Debit
2025-04-16,UPI to Friend,Transfer,-2050,-9074397,Debit
2024-02-20,ATM Withdrawal,Cash,-3766,-9078163,Debit
2024-06-09,Bonus,Income,8559,-9069604,Credit
2024-12-16,Salary Credit,Income,20117,-9049487,Credit
2025-04-14,Amazon Purchase,Shopping,-943,-9050430,Debit
2025-03-15,Doctor Visit,Health,-8506,-9058936,Debit
2024-06-16,Cash Deposit,Cash,-8576,-9067512,Debit
2024-04-24,Doctor Visit,Health,-7706,-9075218,Debit
2024-07-07,Salary Credit,Income,19176,-9056042,Credit
2025-04-29,Bonus,Income,17153,-9038889,Credit
2024-11-28,Refund,Income,15370,-9023519,Credit
2025-01-20,Zomato Order,Food,-5529,-9029048,Debit
2024-06-08,Interest Credit,Savings Interest,20682,-9008366,Credit
2024-02-18,Refund,Income,16095,-8992271,Credit
2024-02-27,Bank Transfer,Transfer,-3514,-8995785,Debit
2024-08-21,Received from Rahul,Transfer,-2973,-8998758,Debit
2024-02-11,YouTube Premium,Entertainment,-6729,-9005487,Debit
2024-12-23,Water Bill,Utilities,-2647,-9008134,Debit
2024-05-27,UPI to Friend,Transfer,-8476,-9016610,Debit
2024-08-29,Cafe Coffee Day,Food,-9918,-9026528,Debit
2024-01-21,Interest Credit,Savings Interest,23677,-9002851,Credit
2024-02-14,Cash Deposit,Cash,-4994,-9007845,Debit
2024-04-15,Flipkart Order,Shopping,-6960,-9014805,Debit
2024-06-17,Freelance Payment,Income,28580,-8986225,Credit
2024-10-09,Doctor Visit,Health,-9919,-8996144,Debit
2025-01-19,Spotify,Entertainment,-6323,-9002467,Debit
2025-03-13,Flipkart Order,Shopping,-8640,-9011107,Debit
2024-01-20,Cafe Coffee Day,Food,-8535,-9019642,Debit
2024-05-22,Bank Transfer,Transfer,-2419,-9022061,Debit
2024-11-13,Flipkart Order,Shopping,-5747,-9027808,Debit
2024-12-14,UPI to Friend,Transfer,-5559,-9033367,Debit
2024-03-15,Zomato Order,Food,-3897,-9037264,Debit
2024-11-19,Petrol,Transport,-2908,-9040172,Debit
2025-02-25,Interest Credit,Savings Interest,2211,-9037961,Credit
2025-03-21,Medical Store,Health,-7707,-9045668,Debit
2025-03-21,Interest Credit,Savings Interest,3874,-9041794,Credit
2025-04-10,Water Bill,Utilities,-6179,-9047973,Debit
2025-03-01,Refund,Income,12318,-9035655,Credit
2024-02-17,ATM Withdrawal,Cash,-5496,-9041151,Debit
2025-02-02,Train Ticket,Transport,-8698,-9049849,Debit
2024-01-21,Electricity Bill,Utilities,-1490,-9051339,Debit
2024-06-21,Salary Credit,Income,15274,-9036065,Credit
2024-10-01,Uber Ride,Transport,-9086,-9045151,Debit
2024-11-16,FD Interest,Savings Interest,24741,-9020410,Credit
2024-10-29,Doctor Visit,Health,-7606,-9028016,Debit
2025-04-03,Train Ticket,Transport,-5066,-9033082,Debit
2024-02-17,Electronics,Shopping,-492,-9033574,Debit
2025-04-04,Medical Store,Health,-2020,-9035594,Debit
2024-03-14,Medical Store,Health,-6212,-9041806,Debit
2024-06-22,Interest Credit,Savings Interest,6313,-9035493,Credit
2025-03-14,Bonus,Income,951,-9034542,Credit
2025-04-17,Interest Credit,Savings Interest,3676,-9030866,Credit
2025-03-08,Swiggy,Food,-5970,-9036836,Debit
2024-05-01,Interest Credit,Savings Interest,24183,-9012653,Credit
2024-09-20,Petrol,Transport,-479,-9013132,Debit
2024-08-12,Bank Transfer,Transfer,-1436,-9014568,Debit
2024-01-24,Movie Tickets,Entertainment,-6435,-9021003,Debit
2025-03-25,Uber Ride,Transport,-9368,-9030371,Debit
2025-03-21,Flipkart Order,Shopping,-3585,-9033956,Debit
2024-10-26,Doctor Visit,Health,-9975,-9043931,Debit
2025-01-25,Spotify,Entertainment,-3121,-9047052,Debit
2024-09-12,Movie Tickets,Entertainment,-2290,-9049342,Debit
2024-04-10,FD Interest,Savings Interest,10115,-9039227,Credit
2025-01-28,Salary Credit,Income,16806,-9022421,Credit
2024-01-01,Flipkart Order,Shopping,-5172,-9027593,Debit
2024-02-29,Cash Deposit,Cash,-7586,-9035179,Debit
2024-04-09,Uber Ride,Transport,-9110,-9044289,Debit
2024-04-27,Uber Ride,Transport,-6684,-9050973,Debit
2024-02-20,Bank Transfer,Transfer,-2893,-9053866,Debit
2024-07-03,Internet Recharge,Utilities,-5109,-9058975,Debit
2024-10-03,Water Bill,Utilities,-6307,-9065282,Debit
2024-02-07,Myntra Shopping,Shopping,-9726,-9075008,Debit
2024-12-09,UPI to Friend,Transfer,-3695,-9078703,Debit
2024-10-15,ATM Withdrawal,Cash,-1443,-9080146,Debit
2024-03-19,Cash Deposit,Cash,-1331,-9081477,Debit
2024-11-24,ATM Withdrawal,Cash,-1826,-9083303,Debit
2025-04-11,ATM Withdrawal,Cash,-2458,-9085761,Debit
2024-04-14,Petrol,Transport,-3231,-9088992,Debit
2024-03-17,Medical Store,Health,-230,-9089222,Debit
2024-02-27,Water Bill,Utilities,-1198,-9090420,Debit
2025-01-06,ATM Withdrawal,Cash,-3148,-9093568,Debit
2025-05-04,Refund,Income,22631,-9070937,Credit
2025-03-17,Train Ticket,Transport,-7603,-9078540,Debit
2024-02-19,Spotify,Entertainment,-2823,-9081363,Debit
2025-02-02,Received from Rahul,Transfer,-3779,-9085142,Debit
2024-05-20,Medical Store,Health,-5427,-9090569,Debit
2024-12-12,Movie Tickets,Entertainment,-9756,-9100325,Debit
2025-05-05,Zomato Order,Food,-4966,-9105291,Debit
2025-01-24,Cash Deposit,Cash,-7990,-9113281,Debit
2025-01-31,Interest Credit,Savings Interest,23138,-9090143,Credit
2024-12-21,Salary Credit,Income,13165,-9076978,Credit
2024-03-28,Bank Transfer,Transfer,-7890,-9084868,Debit
2025-03-01,Water Bill,Utilities,-8824,-9093692,Debit
2024-02-25,Bonus,Income,17197,-9076495,Credit
2024-03-11,Swiggy,Food,-453,-9076948,Debit
2024-02-23,FD Interest,Savings Interest,2240,-9074708,Credit
2024-01-07,Uber Ride,Transport,-2333,-9077041,Debit
2025-04-16,Uber Ride,Transport,-6951,-9083992,Debit
2024-06-06,Freelance Payment,Income,1996,-9081996,Credit
2025-05-15,ATM Withdrawal,Cash,-9017,-9091013,Debit
2025-03-15,Doctor Visit,Health,-4960,-9095973,Debit
2025-05-12,ATM Withdrawal,Cash,-8721,-9104694,Debit
2024-07-06,YouTube Premium,Entertainment,-4670,-9109364,Debit
2024-12-17,Zomato Order,Food,-5398,-9114762,Debit
2024-02-12,Restaurant Bill,Food,-4572,-9119334,Debit
2024-12-07,Uber Ride,Transport,-8487,-9127821,Debit
2024-06-20,Freelance Payment,Income,5062,-9122759,Credit
2024-01-19,Petrol,Transport,-3368,-9126127,Debit
2025-04-26,Medical Store,Health,-3631,-9129758,Debit
2025-02-26,Internet Recharge,Utilities,-8495,-9138253,Debit
2024-04-18,Received from Rahul,Transfer,-3311,-9141564,Debit
2025-01-03,Medical Store,Health,-4873,-9146437,Debit
2025-04-13,Water Bill,Utilities,-5492,-9151929,Debit
2024-05-23,FD Interest,Savings Interest,29789,-9122140,Credit
2025-02-21,ATM Withdrawal,Cash,-8107,-9130247,Debit
2025-01-21,Received from Rahul,Transfer,-1844,-9132091,Debit
2024-03-11,Amazon Purchase,Shopping,-107,-9132198,Debit
2025-01-31,Interest Credit,Savings Interest,13043,-9119155,Credit
2024-08-21,Freelance Payment,Income,25780,-9093375,Credit
2024-10-31,Spotify,Entertainment,-1753,-9095128,Debit
2025-05-02,Water Bill,Utilities,-5349,-9100477,Debit
2024-10-19,Electricity Bill,Utilities,-4592,-9105069,Debit
2024-11-18,Electricity Bill,Utilities,-1270,-9106339,Debit
2024-10-30,Internet Recharge,Utilities,-4214,-9110553,Debit
2024-08-14,Uber Ride,Transport,-4798,-9115351,Debit
2024-07-23,Cash Deposit,Cash,-5830,-9121181,Debit
2024-09-11,Uber Ride,Transport,-8930,-9130111,Debit
2024-07-07,Movie Tickets,Entertainment,-3325,-9133436,Debit
2024-01-04,Cash Deposit,Cash,-9881,-9143317,Debit
2024-12-26,Electricity Bill,Utilities,-510,-9143827,Debit
2024-08-01,Medical Store,Health,-9278,-9153105,Debit
2024-05-17,Electricity Bill,Utilities,-1903,-9155008,Debit
2025-03-29,Refund,Income,16085,-9138923,Credit
2024-02-18,Medical Store,Health,-9046,-9147969,Debit
2024-08-04,Movie Tickets,Entertainment,-2793,-9150762,Debit
2025-02-13,Zomato Order,Food,-6723,-9157485,Debit
2025-03-02,Water Bill,Utilities,-5396,-9162881,Debit
2024-10-16,ATM Withdrawal,Cash,-5825,-9168706,Debit
2024-12-17,Uber Ride,Transport,-7545,-9176251,Debit
2024-08-05,Refund,Income,4203,-9172048,Credit
2024-10-27,Amazon Purchase,Shopping,-2327,-9174375,Debit
2024-01-16,FD Interest,Savings Interest,18801,-9155574,Credit
2024-03-21,ATM Withdrawal,Cash,-8910,-9164484,Debit
2025-01-11,Salary Credit,Income,17623,-9146861,Credit
2024-10-06,Bonus,Income,24271,-9122590,Credit
2025-04-02,YouTube Premium,Entertainment,-460,-9123050,Debit
2024-02-28,ATM Withdrawal,Cash,-4006,-9127056,Debit
2025-01-14,Flipkart Order,Shopping,-521,-9127577,Debit
2025-02-10,Amazon Purchase,Shopping,-1751,-9129328,Debit
2025-05-09,Water Bill,Utilities,-9692,-9139020,Debit
2024-05-08,Myntra Shopping,Shopping,-2606,-9141626,Debit
2024-07-11,Freelance Payment,Income,29730,-9111896,Credit
2024-12-09,ATM Withdrawal,Cash,-227,-9112123,Debit
2024-03-09,FD Interest,Savings Interest,8134,-9103989,Credit
2024-06-26,Movie Tickets,Entertainment,-8758,-9112747,Debit
2025-01-20,Received from Rahul,Transfer,-8744,-9121491,Debit
2024-07-21,Salary Credit,Income,29477,-9092014,Credit
2024-03-07,Uber Ride,Transport,-8469,-9100483,Debit
2024-02-04,Received from Rahul,Transfer,-4204,-9104687,Debit
2025-02-24,Spotify,Entertainment,-8824,-9113511,Debit
2024-03-25,Interest Credit,Savings Interest,18874,-9094637,Credit
2024-04-24,Train Ticket,Transport,-1267,-9095904,Debit
2025-02-12,Medical Store,Health,-5461,-9101365,Debit
2025-01-09,Uber Ride,Transport,-9578,-9110943,Debit
2024-12-11,Received from Rahul,Transfer,-6791,-9117734,Debit
2024-04-12,Swiggy,Food,-8231,-9125965,Debit
2024-07-26,Movie Tickets,Entertainment,-6327,-9132292,Debit
2024-05-29,Freelance Payment,Income,12733,-9119559,Credit
2024-09-26,YouTube Premium,Entertainment,-4635,-9124194,Debit
2025-01-24,Electronics,Shopping,-8831,-9133025,Debit
2024-07-19,Electricity Bill,Utilities,-5078,-9138103,Debit
2025-03-11,Zomato Order,Food,-5464,-9143567,Debit
2024-07-31,Spotify,Entertainment,-5834,-9149401,Debit
2024-01-22,Cash Deposit,Cash,-2610,-9152011,Debit
2025-04-24,Electronics,Shopping,-2536,-9154547,Debit
2024-10-22,Water Bill,Utilities,-3370,-9157917,Debit
2024-12-20,Bank Transfer,Transfer,-9643,-9167560,Debit
2025-02-01,ATM Withdrawal,Cash,-6429,-9173989,Debit
2024-05-15,Cafe Coffee Day,Food,-8958,-9182947,Debit
2024-10-16,Electronics,Shopping,-2343,-9185290,Debit
2024-07-14,Doctor Visit,Health,-5261,-9190551,Debit
2024-11-24,Interest Credit,Savings Interest,17680,-9172871,Credit
2024-01-01,Petrol,Transport,-4251,-9177122,Debit
2024-04-10,Amazon Purchase,Shopping,-575,-9177697,Debit
2024-04-13,Cafe Coffee Day,Food,-6321,-9184018,Debit
2025-04-30,Myntra Shopping,Shopping,-2704,-9186722,Debit
2024-03-04,Petrol,Transport,-6550,-9193272,Debit
2024-03-10,Medical Store,Health,-4860,-9198132,Debit
2024-12-22,Cash Deposit,Cash,-5896,-9204028,Debit
2024-12-30,Received from Rahul,Transfer,-1265,-9205293,Debit
2024-05-23,YouTube Premium,Entertainment,-7338,-9212631,Debit
2024-05-09,Internet Recharge,Utilities,-8815,-9221446,Debit
2024-10-03,Internet Recharge,Utilities,-2882,-9224328,Debit
2025-03-05,Doctor Visit,Health,-7596,-9231924,Debit
2025-01-25,ATM Withdrawal,Cash,-6223,-9238147,Debit
2025-02-25,Medical Store,Health,-9141,-9247288,Debit
2024-05-25,Amazon Purchase,Shopping,-2324,-9249612,Debit
2025-03-23,Bonus,Income,1735,-9247877,Credit
2024-10-12,UPI to Friend,Transfer,-1559,-9249436,Debit
2024-11-21,Medical Store,Health,-9201,-9258637,Debit
2024-03-01,Cash Deposit,Cash,-7595,-9266232,Debit
2024-07-12,Received from Rahul,Transfer,-9487,-9275719,Debit
2024-02-17,Cash Deposit,Cash,-1307,-9277026,Debit
2024-12-27,Interest Credit,Savings Interest,12465,-9264561,Credit
2024-06-18,Refund,Income,26817,-9237744,Credit
2024-12-30,Flipkart Order,Shopping,-7505,-9245249,Debit
2024-04-20,Spotify,Entertainment,-7101,-9252350,Debit
2024-03-07,Cash Deposit,Cash,-2986,-9255336,Debit
2024-12-25,Movie Tickets,Entertainment,-213,-9255549,Debit
2025-03-09,Petrol,Transport,-5197,-9260746,Debit
2024-09-23,Water Bill,Utilities,-2513,-9263259,Debit
2024-08-19,Cafe Coffee Day,Food,-6754,-9270013,Debit
2024-01-09,Restaurant Bill,Food,-9414,-9279427,Debit
2024-04-05,Freelance Payment,Income,2654,-9276773,Credit
2024-07-05,Medical Store,Health,-6268,-9283041,Debit
2024-09-07,Doctor Visit,Health,-2378,-9285419,Debit
2025-01-23,Bank Transfer,Transfer,-7768,-9293187,Debit
2024-07-11,Zomato Order,Food,-894,-9294081,Debit
2025-02-21,Received from Rahul,Transfer,-3445,-9297526,Debit
2024-03-03,Swiggy,Food,-5227,-9302753,Debit
2024-11-05,Spotify,Entertainment,-3060,-9305813,Debit
2024-03-04,Amazon Purchase,Shopping,-8177,-9313990,Debit
2025-05-09,YouTube Premium,Entertainment,-4910,-9318900,Deb